1 0 0 1
1 0 0 0
1 1 0 0
1 1 0 0
1 1 1 0
1 1 1 0

2 2 2 2 2 2 2 2 2 2 2 2 2 2 2 2 2 2 2 0
2 6 6 6 6 6 6 6 6 6 14 6 6 2 2 2 2 2 2 0
2 6 14 6 6 6 6 6 6 6 6 6 6 2 2 2 2 2 2 0
2 6 6 6 6 6 6 6 6 6 6 6 6 2 2 2 2 2 2 0
2 6 6 3 3 3 3 3 3 3 3 3 3 3 3 3 3 3 3 12
2 6 6 3 3 3 3 3 3 3 3 3 3 2 2 2 2 2 2 0
2 6 6 3 3 3 3 3 3 3 3 3 3 2 2 2 2 2 2 0
2 8 6 3 3 3 3 3 3 3 3 3 3 2 2 2 2 2 2 0
2 2 2 3 2 2 2 2 2 2 2 2 2 2 2 2 2 2 2 0
2 2 2 6 2 2 2 2 2 2 2 2 2 2 2 2 2 2 2 0

0 0 0 0 0 0 0 0 0 0 0 0 0 0 0 0 0 0 0 0
0 3 3 3 13 3 3 3 3 3 3 3 3 3 3 3 3 3 3 3
0 9 3 3 3 3 3 3 3 3 13 3 3 3 3 3 3 3 3 0
0 1 1 1 1 1 1 1 1 1 1 1 1 1 13 1 1 1 1 0
3 3 3 3 3 3 13 3 3 3 3 3 3 3 3 3 3 3 3 0
0 3 3 3 3 3 3 3 3 13 3 3 3 3 3 3 3 3 3 0
0 13 3 1 1 1 1 1 1 1 1 1 1 1 1 1 1 3 3 0
0 3 3 13 3 3 3 3 1 5 3 3 3 3 3 3 3 3 3 0
0 3 3 3 3 3 3 13 1 3 3 3 3 3 3 3 3 3 3 0
0 0 0 0 0 0 0 0 0 0 0 0 0 0 0 0 0 0 0 0

0 0 0 0 0 0 0 0 0 0 0 0 0 0 0 0 0 0 0 0
3 3 3 3 3 3 3 3 3 3 3 3 3 3 3 3 3 3 3 12 
0 3 3 3 3 3 3 3 3 3 3 3 3 3 3 13 3 3 3 0
0 3 3 3 3 3 3 3 3 3 3 3 3 13 3 3 3 3 3 0
0 3 3 3 3 3 3 3 3 3 3 3 3 3 3 3 3 13 3 0
0 3 3 3 3 3 3 13 3 3 3 3 3 3 3 3 3 3 3 0
0 3 3 13 3 3 3 3 3 3 3 3 3 3 3 3 3 3 3 0
0 3 3 3 3 13 3 3 3 3 3 3 3 3 3 3 3 3 3 0
0 3 3 3 3 3 3 3 3 3 3 3 3 13 3 3 3 3 5 0
0 0 0 0 0 0 0 0 13 3 3 3 0 0 0 0 0 0 0 0

0 2 2 2 2 2 2 2 2 2 2 2 2 2 2 2 2 2 2 2
3 3 3 3 6 6 6 6 6 6 6 6 6 6 6 6 6 6 7 2
0 3 3 3 6 6 6 6 6 6 6 6 6 6 6 6 6 6 6 2
0 3 3 3 6 6 6 6 6 6 14 6 6 6 6 6 6 6 6 2
0 3 3 3 6 6 6 6 6 6 6 6 6 6 6 6 6 6 6 2
0 3 3 3 6 6 6 6 6 6 6 6 6 14 6 6 6 6 6 2
0 3 13 3 6 6 6 6 6 6 6 6 6 6 6 6 6 6 6 2
0 3 3 3 3 3 3 3 13 3 3 3 3 3 3 3 3 3 3 2
0 2 2 2 2 2 2 2 2 2 2 2 2 2 2 2 2 2 3 2
0 0 0 0 0 0 0 0 0 0 0 0 0 0 0 0 0 2 3 2

2 2 2 6 2 2 2 2 2 2 2 2 2 2 2 2 2 2 2 2
2 6 6 6 6 6 6 6 6 6 6 2 2 2 2 2 2 2 9 2
2 6 6 6 6 6 14 6 6 6 6 6 2 2 2 2 2 2 8 2
2 2 6 6 6 6 6 6 6 6 6 6 6 2 2 2 2 2 6 2
2 2 2 6 6 6 6 6 6 6 6 6 6 6 2 2 2 2 6 2
2 2 2 2 6 6 6 6 6 14 6 6 6 6 6 2 2 2 6 2
2 2 2 2 2 6 6 6 6 6 6 6 6 6 6 6 2 2 6 2
2 6 14 6 2 2 6 6 6 6 6 6 6 6 6 6 6 2 6 2
2 2 2 2 2 2 2 6 6 6 6 6 6 6 6 6 6 6 6 2
2 2 2 2 2 2 2 2 6 2 2 2 2 2 2 2 2 2 2 2

0 0 0 0 0 0 0 0 0 0 0 0 0 0 0 0 0 0 0 0
0 13 3 3 3 3 3 3 3 3 3 3 3 3 3 3 3 3 5 0
0 3 13 3 3 3 3 3 3 3 3 3 3 3 3 3 3 3 3 0
0 1 1 13 1 1 1 1 3 3 3 1 3 3 1 1 3 1 1 0
0 1 3 3 13 1 3 3 1 3 1 1 3 3 1 3 3 1 3 0
0 1 1 3 3 1 13 3 3 1 3 1 3 3 1 1 3 1 1 0
0 3 1 3 3 1 3 13 3 1 3 1 3 3 1 3 3 3 1 0
0 1 1 3 3 1 3 3 13 1 3 1 1 3 1 1 3 1 1 0
0 3 3 3 3 3 3 3 3 13 3 3 3 3 3 3 3 3 3 3
0 0 0 0 0 0 0 0 0 0 0 0 0 0 0 0 0 0 0 0

0 0 0 0 0 0 0 0 3 3 3 3 0 0 0 0 0 0 0 0
0 13 3 3 3 3 3 3 3 3 3 3 3 3 3 3 3 3 5 0
0 3 3 13 3 3 3 3 3 3 3 3 3 3 3 3 3 3 3 0
0 3 3 3 3 13 3 3 3 3 3 3 3 3 3 3 3 3 3 0
0 3 3 3 3 3 3 3 3 3 3 13 3 3 3 3 3 3 3 0
0 3 3 3 3 3 3 3 3 13 3 3 3 3 3 3 3 3 3 0
0 3 3 3 3 3 3 13 3 3 3 3 3 3 3 3 3 3 3 0
0 3 3 3 13 3 3 3 3 3 3 3 3 3 3 3 3 3 3 0
3 13 3 3 3 3 3 3 3 3 3 3 3 3 3 3 3 3 5 0
0 0 0 0 0 0 0 0 3 3 3 3 0 0 0 0 0 0 0 0

0 0 0 0 0 0 0 0 0 0 0 0 0 0 0 0 0 2 3 2
0 3 3 3 3 3 3 1 3 3 1 3 3 3 3 5 0 2 3 2
0 3 3 3 3 3 3 1 13 3 1 3 3 3 3 3 0 2 3 2
0 3 3 3 3 3 3 1 3 3 1 3 3 13 3 3 0 2 3 2
0 3 3 3 3 3 3 3 3 3 3 3 3 13 3 3 0 2 3 2
0 3 3 3 3 3 3 3 3 3 3 3 3 13 3 3 0 2 3 2
0 3 3 3 3 3 3 1 3 3 1 3 3 13 3 3 0 2 3 2
0 3 3 3 3 3 13 1 3 3 1 3 3 3 3 3 0 2 3 2
0 3 3 3 3 3 3 1 3 3 1 3 3 3 3 9 0 2 13 2
0 3 3 0 0 0 0 0 13 3 0 0 0 0 0 0 0 2 3 2

2 2 2 2 2 2 2 2 6 2 2 2 2 2 2 2 2 2 2 2
2 2 2 6 6 6 6 6 6 6 6 6 6 6 6 6 14 6 6 2
2 14 6 6 6 6 6 6 6 6 6 6 6 6 6 6 2 2 2 2
2 6 6 6 2 6 6 6 6 6 6 6 2 2 6 14 2 6 6 6
2 6 6 6 6 14 6 6 6 6 6 6 2 2 6 6 2 6 6 2
2 6 6 6 6 6 6 2 6 6 6 6 6 6 14 6 2 6 6 2
2 6 6 6 6 6 6 6 6 6 6 6 6 6 6 14 2 6 6 6
2 6 6 2 2 6 6 6 6 6 6 14 6 6 6 6 2 2 2 2
2 6 6 6 6 6 8 6 6 6 6 6 6 6 14 6 6 6 6 2
2 2 2 2 2 2 2 2 2 2 2 2 2 2 2 2 2 2 6 2

2 2 2 2 2 2 2 2 2 2 2 2 2 2 2 2 2 2 2 2
2 6 6 6 6 14 6 6 6 6 6 6 6 6 6 6 6 6 8 2
2 6 6 6 6 6 6 6 6 6 6 14 6 6 6 6 6 6 6 2
6 6 6 6 6 6 6 6 6 6 6 6 6 6 6 6 6 6 11 2
2 2 2 2 2 2 2 2 2 2 2 2 2 2 2 2 2 2 2 2
2 6 6 6 14 6 6 6 6 6 6 6 6 6 6 6 6 6 6 2
6 6 6 6 6 6 6 6 6 6 6 14 6 6 6 6 6 6 6 2
2 6 6 6 6 7 6 6 6 6 6 6 14 6 6 6 6 6 6 2
2 6 6 6 6 6 6 6 6 6 6 6 6 14 6 6 6 6 6 2
2 2 2 2 2 2 2 2 2 2 2 2 2 2 2 2 2 6 6 2

0 0 0 0 0 0 0 0 3 3 3 3 0 0 0 0 0 0 0 0
0 3 3 3 3 3 9 1 3 3 3 3 3 3 3 3 1 4 13 0
0 3 3 3 3 3 10 1 3 3 3 3 3 3 3 3 1 3 3 0
0 13 3 1 1 1 1 1 3 3 3 3 3 3 3 3 1 3 3 0
0 3 3 3 3 3 5 1 3 13 3 3 3 3 3 3 1 3 3 0
0 3 3 3 3 3 3 1 3 3 3 13 3 3 3 3 1 3 3 0
0 1 1 1 1 3 3 1 3 3 3 3 3 13 3 3 1 3 3 0
0 3 3 3 3 3 3 1 3 3 3 3 3 3 3 3 1 13 3 0
0 3 3 3 3 3 3 1 3 3 3 3 3 3 3 3 3 3 13 0
0 3 3 0 0 0 0 0 0 0 0 0 3 3 0 0 0 0 0 0

0 3 3 0 0 0 0 0 3 13 0 0 0 0 0 0 0 2 3 2
0 3 3 3 3 0 13 3 3 3 3 3 3 3 3 3 0 2 3 2
0 3 3 3 3 0 0 3 3 3 3 13 3 3 3 3 0 2 3 2
0 3 3 3 13 3 0 3 3 3 3 3 3 3 3 5 0 2 3 2
0 3 3 3 3 3 0 0 3 3 3 3 13 3 3 3 0 2 3 2
0 3 3 3 3 3 3 0 3 13 3 3 3 3 3 3 0 2 3 2
0 3 3 3 3 3 3 0 0 3 3 13 3 3 3 3 0 2 3 2
0 13 3 3 3 3 3 3 0 3 3 3 3 3 3 3 0 2 3 2
0 3 3 3 3 3 3 3 0 0 3 3 13 3 3 3 0 2 3 2
0 0 0 0 0 0 0 3 3 0 0 0 3 13 0 0 0 2 3 2

2 2 2 2 2 2 2 2 2 2 2 2 2 2 2 2 2 2 6 2
2 8 6 6 6 2 2 6 6 6 2 6 6 2 6 6 6 2 6 2
2 6 6 6 14 6 6 6 2 2 6 6 2 6 6 6 6 2 6 2
2 2 2 6 6 6 6 6 2 6 6 6 2 6 6 2 6 6 6 2
2 2 2 6 6 6 6 6 6 2 6 14 6 2 6 2 2 6 6 2
2 6 6 2 6 2 6 6 2 6 6 2 6 6 6 2 6 6 6 2
2 7 6 6 2 6 6 6 6 6 2 6 6 2 6 6 6 6 2 2
2 6 2 6 6 6 2 6 2 2 6 6 6 2 6 2 2 6 6 2
2 2 2 2 6 6 6 6 6 6 6 2 6 2 6 2 6 6 2 2
2 2 2 2 2 6 2 2 2 2 2 2 2 2 2 2 2 2 2 2

2 2 2 2 2 2 2 2 2 2 2 2 2 2 2 2 2 6 6 2
2 6 6 6 6 6 6 6 6 6 6 6 6 6 6 6 6 6 6 2
2 6 6 2 6 6 6 6 6 6 6 6 6 6 6 6 2 8 6 2
2 6 2 2 6 6 6 6 6 6 2 14 2 6 6 6 2 2 6 2
2 6 6 6 6 6 6 6 6 2 2 2 2 2 6 6 6 6 6 2
2 6 6 6 6 6 6 6 6 8 2 6 2 14 6 6 6 6 6 2
2 6 2 2 6 6 6 6 6 2 2 2 2 2 6 6 2 2 6 2
2 6 6 2 6 6 6 6 6 6 2 9 2 6 6 6 2 6 6 2
2 6 6 6 6 6 6 6 6 6 6 6 6 6 6 6 6 6 6 2
2 2 2 2 2 2 2 6 6 2 2 2 2 2 2 2 2 2 2 2

0 3 3 0 0 0 0 0 0 0 0 0 3 3 0 0 0 0 0 0
0 5 3 3 3 3 1 3 3 3 3 3 13 3 3 3 5 1 3 3
0 3 13 3 3 3 1 1 1 1 1 1 3 3 1 1 1 1 3 0
0 1 1 1 3 3 1 3 13 3 3 3 3 3 3 3 3 1 4 0
0 3 3 3 3 13 1 3 1 1 1 1 1 1 1 1 1 1 3 0
0 3 3 3 3 3 1 3 3 3 3 3 13 3 3 3 3 3 3 0
0 3 3 1 1 1 1 1 1 1 1 1 1 1 1 1 1 1 1 0
0 3 3 3 3 3 3 3 3 3 13 3 3 3 3 3 3 3 3 3
0 13 3 3 3 3 3 3 3 3 3 3 3 3 3 3 3 3 3 3
0 0 0 0 0 0 0 0 0 0 3 3 0 0 0 0 0 0 0 0

0 0 0 0 0 0 0 3 3 0 0 0 3 3 0 0 0 2 3 2
3 3 3 3 3 3 3 3 3 1 3 3 3 3 3 13 0 2 3 2
0 1 3 3 3 3 5 3 3 3 1 3 3 3 3 3 0 2 3 2
0 3 1 3 3 3 3 3 3 3 3 1 3 3 3 3 0 2 3 2
0 3 3 1 3 3 3 3 3 3 3 3 1 3 3 3 0 2 3 2
0 3 3 3 1 3 3 3 3 3 3 3 13 1 3 3 0 2 3 2
0 3 3 3 3 1 1 1 1 1 17 1 1 1 1 3 0 2 3 2
3 3 3 3 3 3 5 3 13 3 3 3 3 3 3 3 0 2 3 2
3 3 13 3 3 3 3 3 3 3 3 3 3 4 3 3 0 2 3 2
0 0 0 0 0 0 0 0 0 0 0 0 0 0 0 0 0 2 3 2

2 2 2 2 2 6 2 2 2 2 2 2 2 2 2 2 2 2 2 2
2 14 6 6 6 6 6 6 6 6 6 6 6 6 6 6 6 6 6 2
2 6 6 6 8 2 2 2 2 6 6 6 6 6 6 2 2 2 14 2
2 6 6 6 2 2 2 2 2 2 6 6 6 6 2 2 2 6 6 2
2 6 6 6 2 2 2 2 2 2 6 6 6 6 2 2 2 2 6 2
2 6 6 6 2 2 2 2 2 2 6 6 6 6 2 2 2 2 2 2
2 6 6 6 2 2 2 2 2 2 6 6 6 2 2 2 2 2 6 2
2 6 6 6 7 2 2 2 2 6 6 6 6 2 2 2 2 2 14 2
2 2 2 2 14 6 6 6 6 6 6 6 6 6 6 6 6 6 6 2
2 2 2 2 2 2 2 2 2 2 2 2 2 2 2 6 6 2 2 2

2 2 2 2 2 2 2 6 6 2 2 2 2 2 2 2 2 2 2 2 
2 6 6 14 6 6 6 6 6 6 6 6 6 6 6 6 6 6 6 2
2 6 14 6 6 6 6 6 6 6 6 6 6 6 6 6 6 6 6 6
2 14 6 6 6 6 6 6 6 6 6 6 6 6 6 6 6 6 6 6
2 2 2 2 2 2 2 6 6 14 6 2 2 2 2 2 2 2 2 2
2 6 6 6 6 6 6 6 6 6 6 2 6 6 14 6 6 6 6 2
2 14 6 6 2 2 2 2 2 2 2 2 6 6 6 6 6 6 6 2 
2 6 6 6 6 6 14 6 6 6 6 2 6 6 6 6 6 6 8 2
2 6 6 6 6 6 6 6 6 6 6 6 6 14 6 6 6 6 6 2
2 2 2 2 6 6 2 2 2 2 2 2 2 2 2 2 2 2 2 2

0 0 0 0 0 0 0 0 0 0 3 3 0 0 0 0 0 0 0 0
2 14 6 6 6 8 2 6 6 2 3 3 6 6 6 2 6 7 6 2
6 6 6 6 6 6 2 6 6 2 6 6 6 6 6 6 6 14 6 2
6 6 6 6 6 6 2 6 6 2 6 6 6 6 14 2 6 6 6 2
2 6 6 6 6 2 2 6 14 2 6 6 6 6 6 2 6 6 6 2
2 6 14 6 6 2 6 6 6 6 6 6 6 6 6 2 6 6 6 2
2 6 6 6 6 6 2 2 2 2 2 2 2 2 2 2 6 6 14 2
2 6 6 6 6 6 6 6 6 6 6 6 6 6 6 2 6 14 6 2
2 8 6 6 6 6 6 6 6 6 6 6 6 6 6 2 14 6 8 2
2 2 2 2 2 2 2 2 2 2 2 2 2 2 6 2 2 2 2 2

2 2 2 2 2 2 2 2 2 2 2 2 2 2 2 2 2 2 3 2
2 3 3 3 3 3 3 3 13 3 3 3 3 3 3 5 3 3 3 2
2 2 3 3 2 2 2 2 2 2 2 2 2 2 2 2 2 2 2 2
0 0 3 3 0 0 0 0 0 0 0 0 0 0 0 0 0 0 0 0
0 13 3 3 3 3 3 3 3 3 3 3 3 3 3 3 3 3 3 0
0 3 3 3 3 3 3 13 3 3 3 3 3 3 3 3 3 3 3 0
0 3 1 1 1 1 1 1 1 1 1 1 1 1 1 1 1 13 3 0
0 3 4 1 3 3 3 3 3 3 3 3 3 3 3 3 3 13 3 0
0 3 3 1 3 3 3 3 3 3 3 3 3 13 3 3 3 3 3 0
0 0 0 0 3 3 0 0 0 0 0 0 0 0 0 0 0 0 0 0

2 2 2 2 2 2 2 2 2 2 2 2 2 2 2 6 6 2 2 2
2 7 6 6 6 6 14 6 6 6 6 6 2 6 6 6 6 6 6 2
2 6 6 6 6 6 6 6 6 6 6 6 2 6 6 6 14 6 6 6
2 6 6 6 6 6 2 2 2 6 6 14 2 6 6 6 6 6 6 6
2 6 6 6 6 2 2 2 2 2 6 6 2 2 2 2 2 2 2 2
2 6 6 6 2 2 2 2 2 2 2 6 2 2 2 2 2 2 2 2
2 6 6 6 2 2 2 2 2 2 2 6 2 2 2 2 6 6 6 6
2 6 6 6 6 6 6 6 6 6 6 6 6 6 14 6 6 6 6 6
2 6 6 16 6 8 6 6 6 6 6 6 6 6 6 6 6 6 6 2
2 2 2 2 2 2 2 2 2 2 2 2 2 2 2 2 2 2 2 2

2 2 2 2 6 6 2 2 2 2 2 2 2 2 2 2 2 2 2 2
2 6 6 2 6 8 6 6 2 2 2 6 6 14 6 6 6 6 6 6
6 6 6 6 2 6 6 14 6 2 2 6 6 6 6 6 6 6 6 6
6 6 6 6 6 2 2 2 6 6 2 6 6 6 6 2 2 2 2 2
2 2 2 6 6 6 6 6 2 6 2 14 6 6 6 2 8 6 6 2
2 6 6 2 6 6 6 6 6 6 2 6 6 6 6 2 6 6 6 2
6 6 6 6 2 2 2 2 2 2 2 6 14 6 6 2 6 6 6 2
6 6 6 6 6 6 6 6 6 6 14 6 6 6 6 6 6 6 6 2
2 6 6 6 14 6 6 6 6 6 6 6 6 6 6 6 6 6 6 2
2 2 2 2 2 2 2 2 2 2 2 2 2 2 2 2 2 2 2 2

2 2 2 2 2 2 2 2 2 2 2 2 2 2 6 2 2 2 2 2
6 6 2 6 6 6 2 7 6 6 6 6 6 6 6 6 6 2 6 2
6 6 2 6 2 6 2 8 6 6 6 6 6 6 6 2 6 6 6 2
2 6 2 6 2 14 2 2 2 2 2 2 2 2 2 2 2 2 6 2
2 6 2 6 2 6 2 6 6 6 6 6 6 6 6 6 6 6 6 2
2 6 2 6 2 6 2 6 2 2 2 2 2 2 2 2 2 2 2 2
2 6 2 6 2 6 2 6 6 6 6 6 6 6 14 6 6 6 6 2
2 6 2 6 2 6 2 2 2 2 2 2 2 2 2 2 2 2 6 2
2 6 6 6 2 6 6 6 6 6 6 6 6 6 6 6 6 6 6 2
2 2 2 2 2 2 2 2 2 2 2 2 2 2 2 2 2 2 2 2

0 0 0 0 3 3 0 0 0 0 0 0 0 0 0 0 0 0 0 0
0 1 1 1 1 5 1 3 3 3 3 3 3 3 3 3 3 3 13 0
0 13 3 3 1 3 1 3 3 1 1 1 1 1 1 1 1 3 3 0
0 3 1 3 1 3 1 3 3 1 15 1 3 3 3 9 1 3 3 0
0 13 1 3 1 3 1 3 3 1 3 3 5 1 3 3 1 3 3 0
0 13 1 3 1 3 1 3 3 1 1 1 1 1 3 3 1 3 3 0
0 3 1 10 1 3 1 3 3 3 3 3 3 3 3 3 1 3 3 0
0 3 1 1 1 3 1 1 1 1 1 1 1 1 1 1 1 13 3 0
0 3 3 3 3 3 12 3 3 3 3 3 3 3 3 3 3 3 3 0
0 0 0 0 0 0 0 0 0 0 0 0 0 0 0 0 0 0 0 0
