0 0 0 0
0 0 0 0
0 1 1 0
0 1 1 0
0 0 0 0
0 0 0 0

0 0 0 0 0 0 0 0 0 0 0 0 0 0 0 0 0 0 0 0
0 3 3 3 3 3 3 3 3 3 3 3 3 3 3 3 13 3 3 0
0 3 0 3 3 3 3 3 3 3 13 3 3 3 3 3 3 3 3 0
0 3 0 3 3 3 3 3 3 3 3 3 3 3 3 3 3 3 3 12
0 3 0 3 3 3 3 3 3 3 3 13 3 3 3 3 3 3 3 0
0 3 0 3 3 3 3 3 3 3 3 3 3 13 3 3 3 3 3 0
0 3 0 13 3 3 3 3 3 3 3 3 3 3 3 3 3 3 3 0
0 3 0 3 3 3 3 3 3 3 3 3 3 3 3 13 3 3 3 0
0 3 0 3 10 3 3 3 3 3 3 3 3 3 3 3 3 3 9 0
0 3 0 0 0 0 0 0 0 0 0 0 0 0 0 0 0 0 0 0

0 0 0 0 0 0 0 0 0 0 0 0 0 0 0 0 0 0 0 0
0 3 3 3 3 3 3 3 3 3 3 3 3 13 3 3 3 3 3 0
0 3 3 3 3 3 3 13 3 3 3 3 3 3 3 3 3 3 3 0
3 3 3 3 3 3 3 3 3 3 3 3 13 3 3 3 3 3 3 0
0 3 3 3 3 3 3 3 3 13 3 3 3 3 3 3 3 3 3 0
0 3 3 3 3 3 3 3 3 3 3 3 3 3 3 3 3 3 15 0
0 3 3 3 13 3 3 3 3 3 3 3 3 3 3 3 3 3 3 0
0 3 3 3 3 3 3 3 3 3 3 3 3 13 3 3 3 3 3 0
0 3 3 3 3 3 3 3 13 3 3 3 3 3 3 3 3 3 3 0
0 0 0 0 0 0 0 0 0 0 0 0 0 0 0 0 0 0 0 0

0 0 0 0 0 0 0 0 0 0 0 0 0 0 0 0 0 0 0 0
0 3 3 3 3 3 3 3 3 3 3 3 3 3 3 13 3 3 3 3
0 3 3 3 13 3 3 3 3 3 3 3 3 3 3 3 3 3 3 0
0 3 3 3 3 3 3 3 3 3 3 3 3 3 3 3 13 3 3 0
0 3 3 13 3 3 3 3 3 3 3 3 3 3 3 3 3 3 3 0
0 3 3 3 3 3 3 3 3 3 3 3 3 3 3 3 3 13 3 0
0 3 13 3 3 3 3 3 3 3 3 3 3 3 3 3 3 3 3 0
0 3 3 3 3 3 3 3 3 3 3 3 3 3 3 3 3 3 13 0
0 15 3 3 3 3 3 3 3 3 3 3 3 3 3 3 3 3 3 0
0 0 0 0 0 0 0 0 0 0 0 0 0 0 0 0 0 0 0 0

0 0 0 0 0 0 0 0 0 0 0 0 0 0 0 0 0 0 0 0
12 3 3 3 3 3 3 3 3 3 3 3 3 3 3 3 3 3 5 0
0 3 3 3 3 3 3 13 3 3 3 3 3 3 3 3 3 3 5 0
0 3 3 3 3 3 13 3 3 3 3 3 3 3 3 3 3 3 5 0
0 3 3 3 3 13 3 3 3 3 3 3 3 3 3 3 3 3 5 0
0 3 3 3 13 3 3 3 3 3 3 3 3 3 3 3 3 3 5 0
0 3 3 13 3 3 3 3 3 3 3 3 3 3 3 3 3 3 5 0
0 3 13 3 3 3 3 3 3 3 3 3 3 3 3 3 3 3 5 0
0 10 3 3 3 3 3 3 3 3 3 3 3 3 3 3 3 3 5 0
0 0 0 0 0 0 0 0 0 0 0 0 0 0 0 0 0 0 3 0

0 12 0 0 0 0 0 0 0 0 0 0 0 0 0 0 0 0 0 0
0 3 3 3 3 3 3 3 3 13 3 3 3 3 3 3 3 3 4 0
0 3 3 3 3 3 3 3 13 3 3 3 3 3 3 3 3 3 3 0
0 3 3 3 3 3 3 13 3 3 3 3 3 3 3 3 3 3 3 3
0 3 3 3 3 3 13 3 3 3 3 3 3 3 3 3 3 3 3 0
0 5 3 3 3 13 3 3 3 3 3 3 3 3 3 3 3 3 5 0
0 0 0 0 0 0 0 0 0 0 0 0 0 0 0 0 0 0 0 0
0 13 3 3 3 3 3 3 3 3 3 3 3 3 3 3 3 3 3 0
0 3 3 3 3 3 3 3 16 3 3 3 3 3 3 3 3 3 13 0
0 0 0 0 0 0 0 0 0 0 0 0 0 0 0 0 0 0 13 0

0 0 0 0 0 0 0 0 0 0 0 0 0 0 0 0 0 0 0 0
0 4 3 3 3 13 3 3 3 3 3 3 3 3 3 3 3 3 3 3
0 3 3 3 3 3 3 3 3 3 3 3 3 3 13 3 3 3 3 3
3 3 3 3 3 13 3 3 3 3 3 3 3 3 3 3 3 3 3 3
0 3 3 3 13 3 3 3 3 3 3 3 3 3 3 3 3 3 3 3
0 3 3 13 3 3 3 3 3 3 3 3 3 3 3 3 3 3 3 3
0 3 13 3 3 3 3 3 3 3 3 3 3 3 3 3 3 3 3 3
0 3 3 3 13 3 3 3 3 3 3 3 3 3 3 3 3 3 3 3
0 10 3 3 3 3 3 3 3 3 3 3 3 3 3 3 3 3 5 3
0 0 0 0 0 0 0 0 0 0 0 0 0 0 0 0 0 0 0 0

0 0 0 0 0 0 0 0 0 0 0 0 0 0 0 0 0 0 0 0
3 4 3 3 3 3 3 3 3 3 3 3 3 3 3 3 3 3 3 0
3 3 3 3 3 3 3 3 3 3 3 3 3 3 13 3 3 3 3 0
3 3 3 3 3 3 3 3 3 3 3 3 3 3 3 3 3 3 3 3
3 3 3 3 3 3 3 3 3 3 3 3 3 3 3 3 3 3 3 0
3 3 3 3 3 3 3 3 3 3 3 3 3 3 3 3 3 3 3 0
3 3 3 3 3 3 3 3 3 3 3 3 3 3 3 3 3 3 3 0
3 3 3 3 13 3 3 3 3 3 3 3 3 3 3 3 3 3 3 0
3 3 3 3 3 3 3 3 3 3 3 3 3 3 3 3 3 3 5 0
0 0 0 0 0 0 0 0 0 3 0 0 0 0 0 0 0 0 0 0

0 0 0 0 0 0 0 0 0 0 0 0 0 0 0 0 0 0 12 0
0 4 3 3 3 3 13 3 3 3 3 3 3 3 3 3 3 3 3 0
0 3 3 3 3 3 3 13 3 3 3 3 3 3 3 3 3 3 3 0
3 3 3 3 3 3 3 3 13 3 3 3 3 3 3 3 3 3 3 0
0 3 3 3 3 3 3 3 3 13 3 3 3 3 3 3 3 3 3 0
0 3 3 3 3 3 3 3 3 3 13 3 3 3 3 3 3 3 3 0
0 3 3 3 3 3 3 3 3 3 3 13 3 3 3 3 3 3 3 0
0 3 3 3 3 3 3 3 3 3 3 3 13 3 3 3 3 3 3 0
0 5 3 3 3 3 3 3 3 3 3 3 3 13 3 3 3 3 5 0
0 0 0 0 0 0 0 0 0 0 0 0 0 0 0 0 0 0 0 0

0 0 0 0 0 0 0 0 0 0 0 0 0 0 0 0 0 0 3 0
0 13 3 3 3 3 3 3 3 3 3 3 3 3 3 3 3 3 5 0
0 3 3 3 3 3 3 3 3 3 3 3 3 3 3 3 0 0 0 0
0 3 3 3 3 3 3 3 3 3 3 3 3 3 3 3 0 3 3 12
0 3 3 3 3 3 3 3 3 3 3 3 3 3 3 3 0 3 3 0
0 3 3 3 3 3 3 3 3 13 3 3 3 3 3 3 0 3 3 0
0 3 3 3 3 3 3 3 3 3 3 3 3 3 3 3 0 3 3 0
0 13 3 3 3 3 3 3 3 3 3 3 3 3 3 3 0 3 3 0
0 3 3 3 3 3 3 3 3 3 3 3 3 3 3 3 0 3 3 0
0 3 3 3 3 3 3 3 3 13 3 3 3 3 3 3 0 3 3 0

0 0 0 0 0 0 0 0 0 0 0 0 0 0 0 0 0 0 0 0
0 2 2 2 2 2 2 2 2 2 2 2 2 2 2 2 2 2 2 1
0 2 6 6 6 6 6 6 6 6 6 6 6 6 6 6 6 6 2 1
3 3 3 3 3 3 3 3 3 3 3 3 3 3 3 3 3 3 2 1
0 2 6 6 6 6 6 6 6 6 6 6 6 6 6 6 6 3 2 1
0 2 6 6 6 6 6 6 6 6 14 6 6 6 6 6 6 3 2 1
0 2 6 6 6 6 6 6 6 6 6 6 6 6 6 6 6 3 2 1
0 2 6 6 6 6 6 6 6 6 6 6 6 6 6 6 6 3 2 1
0 2 7 6 6 6 6 14 6 6 6 6 6 6 6 6 6 3 2 1
0 2 2 2 2 2 2 2 2 2 2 2 2 2 2 2 2 3 2 1

0 0 0 0 0 0 0 0 0 12 0 0 0 0 0 0 0 0 0 0
1 2 14 6 3 3 3 3 3 3 3 3 3 3 4 3 3 3 6 0
1 2 14 6 2 2 2 2 2 2 2 2 2 2 2 2 2 3 6 0
1 2 14 6 3 3 3 3 3 3 3 3 3 3 3 3 3 3 6 0
1 2 6 6 2 2 2 2 2 2 2 2 2 2 2 2 2 13 6 0
1 2 6 6 3 3 3 5 3 3 3 3 3 13 3 3 3 3 6 0
1 2 14 6 2 2 2 2 2 2 2 2 2 2 2 2 2 3 6 0
1 2 14 6 3 3 3 3 3 3 3 3 3 3 3 3 3 3 3 0
1 2 14 8 6 6 6 6 6 6 6 6 6 6 6 6 6 6 3 0
1 2 2 2 2 2 2 2 2 2 2 2 2 2 2 2 2 2 3 0

0 0 0 0 0 0 0 0 0 0 0 0 0 0 0 0 0 0 0 0
0 13 3 3 3 3 3 3 3 3 3 3 3 3 3 3 3 3 3 0
0 3 3 3 3 3 3 3 3 3 3 3 3 13 3 3 3 3 3 0
0 3 3 3 0 0 0 0 0 0 0 0 0 0 0 0 13 3 3 0
0 3 3 3 0 0 0 0 0 0 0 0 0 0 0 0 3 3 13 0
0 3 3 3 0 0 13 3 3 3 3 3 3 3 0 0 3 3 3 0
0 3 3 3 0 0 3 3 3 3 3 3 13 3 0 0 3 3 3 0
0 3 3 3 0 0 3 3 3 0 0 3 3 3 0 0 13 3 3 0
0 13 3 3 0 0 3 3 3 0 0 3 3 3 0 0 3 3 3 0
0 3 3 13 0 0 3 3 3 0 0 3 3 3 0 0 3 3 3 0

0 3 3 3 3 3 3 3 3 3 3 3 3 3 3 3 0 3 3 0
0 3 3 3 3 3 3 3 3 3 3 3 3 3 3 0 3 3 3 0
0 3 3 3 3 3 3 3 3 3 3 3 3 3 0 3 3 3 3 0
0 3 3 3 3 3 3 5 3 3 3 3 3 0 3 3 3 4 3 0
0 3 3 3 3 3 3 3 3 3 3 3 0 3 3 3 3 3 3 0
0 3 13 3 3 3 3 3 3 3 3 0 3 3 3 3 3 3 3 0
0 3 3 3 3 3 3 3 3 3 0 3 3 3 3 3 3 3 3 0
0 3 3 3 3 3 3 3 3 0 3 3 3 13 3 3 3 3 3 0
0 3 3 3 3 3 3 3 0 3 3 3 3 3 3 3 3 3 3 0
0 3 3 3 3 3 3 0 3 3 3 3 3 3 3 3 0 3 3 0

0 2 2 2 2 2 2 2 2 2 2 2 2 2 2 2 2 2 3 1
0 14 6 6 6 6 6 8 6 6 6 6 6 6 6 6 6 3 3 1
0 14 3 3 3 3 3 3 3 3 3 3 3 3 3 3 3 3 2 1
0 14 3 2 2 2 2 2 2 2 2 2 2 2 2 2 2 2 2 1
0 6 3 3 3 3 3 3 3 3 3 3 13 3 3 3 3 3 2 1
0 6 3 3 3 3 3 3 3 3 3 3 3 13 3 3 3 3 2 1
0 6 3 3 3 3 3 3 3 3 3 3 3 13 3 3 3 3 3 3
0 6 6 6 6 6 6 6 6 6 14 6 6 6 6 6 6 6 2 1
0 2 2 2 2 2 2 2 2 2 2 2 2 2 2 2 2 2 2 1
0 0 0 0 0 0 0 0 0 0 0 0 0 0 0 0 0 0 0 0

1 2 2 2 2 2 2 2 2 2 2 2 2 2 2 2 2 2 3 0
1 3 3 3 3 3 3 3 3 13 3 3 3 3 3 3 3 3 3 0
1 3 2 2 2 2 2 2 2 2 3 3 2 2 2 2 2 3 14 0
1 3 2 2 2 2 2 2 2 2 3 3 2 2 2 2 2 3 6 0
1 3 2 2 2 2 2 2 2 2 3 3 2 2 2 2 2 3 6 0
1 3 2 2 2 2 2 2 2 2 3 3 2 2 2 2 2 3 6 0
3 3 3 3 3 3 13 3 3 3 3 3 3 3 3 3 3 3 6 0
1 6 2 2 2 2 2 2 2 2 3 3 2 2 2 2 2 3 6 0
1 6 2 2 2 2 2 2 2 2 3 3 2 2 2 2 2 3 11 0
0 0 0 0 0 0 0 0 0 0 0 0 0 0 0 0 0 0 0 0

0 3 3 3 0 0 10 3 9 0 0 3 3 3 0 0 3 3 3 0
0 3 3 3 0 0 0 0 0 0 0 3 3 3 0 0 3 13 3 0
0 13 3 3 3 3 3 3 3 0 0 3 3 3 3 3 3 3 3 0
0 3 3 3 3 3 3 3 3 0 0 13 3 3 3 3 3 3 3 0
0 3 3 3 3 3 13 3 3 0 0 3 3 3 3 3 3 3 3 0
0 3 3 3 3 3 3 3 3 0 0 3 3 3 13 3 3 3 3 0
0 3 3 13 3 3 3 3 3 0 0 3 3 3 3 3 3 3 3 0
0 3 3 3 3 3 3 3 3 0 0 3 3 3 3 13 3 3 3 0
0 3 3 3 3 3 13 3 3 0 0 3 3 3 3 3 3 3 5 0
0 5 3 3 3 3 3 3 3 0 0 13 3 3 3 3 3 3 3 0

0 3 3 3 3 3 3 0 3 3 3 3 3 3 3 3 0 3 3 0
0 3 3 3 3 3 3 0 0 3 3 3 3 3 3 3 0 3 3 0
0 3 3 3 13 3 3 0 9 0 3 3 3 3 3 3 0 3 3 0
0 3 3 3 3 3 3 0 3 3 0 3 3 3 3 3 0 3 13 0
0 3 3 3 3 3 3 0 3 3 3 0 3 3 3 3 0 3 3 0
0 3 3 3 3 3 3 0 3 3 3 3 0 3 3 3 0 13 3 0
0 3 3 3 3 3 3 0 3 3 3 3 3 0 5 5 0 3 3 0
0 3 3 3 3 3 3 0 3 3 3 3 3 3 0 5 0 3 3 0
0 3 3 13 3 3 3 0 3 3 3 3 3 3 3 0 0 3 3 0
0 3 3 3 3 3 3 0 3 3 3 3 3 3 3 3 0 3 3 0

0 0 0 0 0 0 0 0 0 0 0 0 0 0 0 0 0 0 0 0
0 13 3 3 3 3 3 3 3 3 3 3 3 3 3 3 3 3 3 3
0 3 13 3 3 3 3 3 3 3 3 3 3 3 3 3 3 3 3 3
0 3 3 3 3 3 3 3 3 3 3 3 3 3 3 3 3 3 3 3
0 3 3 3 3 3 3 3 3 3 3 3 3 3 3 3 3 3 3 3
0 3 3 3 3 3 3 3 3 3 3 3 3 3 3 3 3 3 3 3
0 3 3 3 3 3 3 3 5 3 3 3 3 3 3 3 3 3 3 3
0 3 3 3 3 3 5 3 3 3 3 3 3 3 3 3 3 3 4 3
0 3 3 3 3 3 3 3 3 3 3 3 3 3 3 3 3 3 3 3
0 3 3 3 3 3 3 3 3 3 3 3 3 3 3 3 3 3 3 0

0 0 0 0 0 0 0 0 0 0 0 0 0 0 0 0 0 0 0 0
3 3 3 3 3 3 3 3 13 3 3 3 3 3 3 3 3 3 3 0
3 3 3 3 3 3 3 3 3 13 3 3 3 3 3 3 3 3 3 0
3 3 3 3 3 3 3 3 3 3 13 3 3 3 3 3 3 3 3 0
3 3 3 3 3 3 3 3 3 3 3 13 3 3 3 3 3 3 3 0
3 3 3 3 3 3 3 3 3 3 3 3 13 3 3 3 3 3 3 0
3 3 3 3 3 3 3 3 3 3 3 3 3 13 3 3 3 3 3 0
3 3 3 3 3 3 3 3 3 3 3 3 3 3 13 3 3 3 3 0
3 3 3 3 3 3 3 3 3 3 3 3 3 3 3 13 3 3 3 0
0 3 3 3 3 3 3 3 3 3 3 3 3 3 3 3 13 3 3 0

0 3 3 3 3 3 3 3 3 0 0 3 3 3 3 3 3 3 3 0
0 3 3 3 3 3 3 3 3 0 0 3 3 3 3 3 3 3 3 0
0 3 3 3 3 3 3 3 3 0 0 3 3 13 3 3 3 3 3 0
0 3 3 3 3 5 3 3 3 0 0 3 3 3 3 3 3 3 3 0
0 3 3 3 3 3 3 3 3 0 0 3 3 3 3 3 3 3 3 0
0 3 3 3 3 3 3 3 3 0 0 3 3 3 3 5 3 3 3 0
0 3 3 3 3 3 3 3 3 0 0 3 3 3 3 3 3 3 3 0
0 3 3 13 3 3 3 3 3 0 0 3 3 3 3 3 3 3 3 0
0 3 3 3 3 3 3 3 3 0 0 3 3 3 3 3 3 3 3 0
0 3 3 3 3 3 3 3 0 0 0 3 3 3 3 3 3 3 3 0

0 3 13 3 3 3 3 0 3 3 3 3 3 3 3 3 0 3 3 0
0 3 3 3 3 3 3 0 3 3 13 3 3 3 3 3 3 3 3 3
0 3 3 3 3 3 5 0 3 3 3 3 3 13 3 3 3 3 5 3
0 3 3 3 3 3 3 0 3 3 3 13 3 3 3 3 3 3 3 3
0 3 3 3 3 3 3 0 0 0 0 0 0 0 0 0 0 0 0 0
0 3 3 13 3 3 3 3 3 3 3 3 3 3 3 3 3 3 3 3
0 3 3 3 3 13 3 3 3 3 3 3 3 3 3 3 3 3 3 3
0 3 3 3 3 3 13 3 3 3 3 3 3 3 3 3 3 3 3 3
0 3 3 3 3 3 3 3 3 13 3 3 3 3 3 3 3 3 3 3
0 0 0 0 0 0 0 0 0 0 0 0 0 0 0 0 0 0 0 0

0 3 3 3 3 3 3 3 3 3 3 3 3 13 3 3 3 3 3 0
3 3 3 3 3 3 3 3 3 3 3 3 3 3 3 13 3 3 3 0
3 3 3 3 13 3 3 3 3 3 3 3 3 3 3 3 3 3 4 0
3 3 3 3 3 3 3 3 3 13 3 3 3 3 3 3 3 3 3 0
0 0 0 0 0 0 0 0 0 0 0 0 0 0 0 0 0 0 0 0
3 3 3 3 3 3 3 13 3 3 13 3 3 3 3 3 3 3 3 3
3 3 3 3 3 3 13 3 3 3 3 13 3 3 3 3 3 3 3 0
3 3 3 3 3 13 3 3 3 3 3 3 13 3 3 3 3 3 3 0
3 3 3 3 13 3 3 3 3 3 3 3 3 13 3 3 3 3 3 0
0 0 0 0 0 0 0 0 0 0 0 0 0 0 0 0 0 0 0 0

0 3 3 3 3 3 3 3 3 3 3 3 3 3 3 3 3 3 3 0
0 3 3 3 3 3 3 3 3 3 3 3 13 3 3 3 3 3 3 3
0 3 3 3 13 3 3 3 3 3 3 3 3 3 3 3 3 3 3 3
0 3 3 3 3 3 3 3 3 3 3 3 3 13 3 3 3 3 3 3
0 0 0 0 0 0 0 0 0 0 0 0 0 0 0 0 0 0 0 0
3 3 3 3 3 3 3 9 3 3 5 3 3 3 3 3 3 3 3 3
0 3 3 3 3 3 3 3 3 3 3 3 3 3 3 3 3 3 3 3
0 3 3 3 3 3 3 3 3 3 3 3 3 3 3 3 3 3 3 3
0 3 3 3 3 3 3 3 3 3 3 3 3 3 3 3 3 3 3 3
0 0 0 0 0 0 0 0 0 0 0 0 0 0 0 0 0 0 0 0

0 3 3 3 3 3 3 3 0 0 0 3 3 3 3 3 3 3 3 0
3 3 3 3 13 3 3 3 0 5 3 3 3 3 3 3 3 3 3 0
3 3 3 3 3 13 3 3 0 3 3 3 3 3 3 3 3 3 3 0
3 3 3 3 3 3 13 3 0 3 3 3 3 3 3 3 3 3 13 0
0 0 0 0 0 0 0 0 0 3 3 3 3 3 3 3 3 13 3 0
3 3 3 3 3 3 3 3 3 3 3 3 3 3 3 3 13 3 3 0
3 3 3 3 3 3 3 3 3 3 3 3 3 3 3 13 3 3 3 0
5 3 3 3 3 3 3 3 3 3 3 3 3 3 13 3 3 3 3 0
3 3 3 3 3 3 3 3 3 3 3 3 3 13 3 3 3 3 3 0
0 0 0 0 0 0 0 0 0 0 0 0 0 0 0 0 0 0 0 0