0 1 1 1
1 1 1 1
1 1 1 1
1 1 1 1
1 1 1 1
1 1 1 1

0 0 0 0 0 0 0 0 0 0 0 0 0 0 0 0 0 0 0 0
0 13 3 3 3 3 3 5 3 3 3 3 3 3 3 3 3 3 3 0
0 3 1 1 1 1 1 1 1 1 1 1 1 1 1 13 3 1 1 0 
0 13 1 3 3 3 3 3 3 3 3 3 3 3 1 3 3 1 3 3
0 4 1 3 3 1 1 1 1 1 1 1 1 13 3 3 3 3 3 0 
0 13 1 3 3 3 3 1 3 3 3 3 1 1 1 1 1 1 1 0
0 3 1 3 3 3 3 1 3 3 3 3 3 3 3 1 5 13 3 0
0 13 3 3 1 1 1 1 3 3 3 3 3 1 1 1 1 1 3 0
0 3 1 3 3 3 3 3 3 3 3 3 3 3 3 3 3 13 3 0
0 0 0 0 0 3 0 0 0 0 0 0 0 0 0 0 0 0 0 0

0 2 2 2 2 2 2 2 2 2 2 2 2 2 2 2 2 2 2 2
0 2 2 2 2 2 2 2 2 2 2 14 6 6 6 8 6 2 2 2
0 2 2 2 2 2 2 2 2 2 2 2 6 6 2 6 6 2 2 2
12 3 6 6 6 6 6 6 6 6 2 2 2 6 6 2 6 6 6 6
0 2 6 6 2 2 2 2 2 6 6 2 2 2 6 6 2 2 2 2
0 2 2 6 6 14 6 6 6 6 6 6 2 2 2 6 6 6 6 6
0 2 2 2 6 6 6 6 6 6 6 6 6 2 2 2 6 2 2 2
0 2 2 2 2 6 6 6 6 6 6 6 14 6 2 2 2 2 2 2
0 2 2 2 2 2 14 6 6 6 6 6 6 6 6 6 6 6 2 2
0 2 2 2 2 2 2 2 2 2 2 2 2 2 2 6 6 6 2 2

2 2 2 2 2 2 2 2 2 2 2 2 2 2 2 2 2 2 2 2
2 2 2 2 2 2 2 2 2 2 2 2 2 2 2 2 2 2 2 2
2 2 2 2 2 2 2 2 2 2 2 2 2 2 2 2 2 2 2 2
6 6 6 14 6 6 6 6 6 6 6 6 6 6 6 6 6 6 6 6
2 2 2 2 2 2 2 2 1 6 6 14 6 6 6 6 6 6 6 6
6 6 14 6 2 2 2 2 1 6 6 6 6 6 6 6 2 2 2 2
2 2 2 6 6 2 2 2 1 14 6 6 6 6 6 6 2 2 2 2
2 2 2 2 6 6 2 2 1 6 6 14 6 6 6 6 2 2 2 2
2 2 2 2 2 6 6 2 1 6 6 6 6 14 6 6 2 2 2 2
2 2 2 2 2 2 6 2 1 6 6 6 6 6 6 14 2 2 2 2

2 2 2 2 2 2 2 2 2 2 2 2 2 2 2 2 2 2 2 2
2 6 6 6 6 6 6 6 6 6 6 6 6 6 6 6 6 6 14 2
2 6 6 6 2 2 2 2 2 2 2 2 2 6 6 6 6 14 6 2
6 6 6 6 2 2 2 2 2 2 2 2 2 6 6 6 14 6 6 2
6 6 14 6 2 2 2 2 2 2 2 2 2 6 2 2 2 2 2 2
2 2 2 2 2 2 2 2 14 6 6 6 6 6 2 2 2 2 2 2
2 2 2 2 2 2 2 2 6 14 6 6 6 6 2 2 2 2 2 2
2 2 2 2 2 6 6 6 6 6 14 6 6 6 2 2 2 2 2 2
2 2 2 2 2 6 6 6 6 6 6 14 6 6 2 2 2 2 2 2
2 2 2 2 2 6 6 2 2 2 2 2 2 2 2 2 2 2 2 2

0 0 0 0 0 3 0 0 0 0 0 0 0 0 0 0 0 0 0 0
2 2 2 2 2 3 2 2 2 2 2 2 2 2 2 2 2 2 2 2
2 2 2 2 6 6 6 6 6 6 6 6 6 6 6 14 6 6 6 2
2 2 2 6 6 6 2 2 2 2 2 2 2 2 2 2 2 2 14 2
2 2 6 6 2 6 14 2 2 2 2 2 2 2 2 2 2 2 6 2
2 6 2 6 6 14 6 6 2 2 2 2 2 2 2 2 2 2 6 6
2 6 6 6 14 6 2 6 6 2 2 2 2 2 2 2 2 2 2 2
2 6 2 14 2 6 6 6 6 6 2 2 2 2 2 2 2 2 2 2
2 14 6 6 6 6 2 6 6 6 6 6 6 6 6 6 6 6 6 6
2 2 2 2 2 2 2 2 2 2 2 2 2 2 2 2 2 2 2 2

2 2 2 2 2 2 2 2 2 2 2 2 2 2 2 6 6 6 2 2
2 6 6 6 6 6 6 6 6 6 6 14 6 6 6 2 6 6 6 2
2 6 6 1 6 1 6 1 14 1 6 1 6 1 6 1 2 6 6 6
2 6 6 1 14 1 6 1 6 1 6 1 6 1 6 1 6 2 6 6
2 6 14 1 2 1 2 1 2 1 2 1 2 1 2 1 6 6 2 6
6 6 6 1 6 1 14 1 6 1 6 1 6 1 6 1 6 6 6 2
2 6 6 1 14 1 6 1 6 1 6 1 6 1 6 1 6 6 6 2
2 2 6 6 6 6 6 6 6 6 6 6 6 6 6 6 14 6 6 2
6 6 2 6 6 6 6 6 6 6 6 6 6 6 6 6 6 14 6 2
2 6 2 2 6 6 2 2 2 2 2 2 2 2 2 2 2 2 2 2

2 2 2 2 2 2 8 2 1 6 6 6 6 6 6 6 2 2 2 2
2 14 6 6 6 6 6 2 1 6 6 6 6 6 6 6 2 2 2 2
6 6 6 6 6 14 2 2 1 6 6 6 1 6 6 6 2 2 2 2
6 6 6 6 14 2 2 2 1 6 6 6 1 6 6 6 2 2 2 2
6 6 14 6 2 2 2 2 1 6 1 1 1 6 6 6 2 2 2 2
2 2 2 2 2 2 2 2 1 6 6 6 1 1 1 6 6 6 14 2
2 1 1 1 1 1 1 1 1 6 6 6 1 6 6 6 6 6 14 2
2 8 8 6 6 6 6 6 6 6 6 6 1 6 6 6 6 6 14 2
2 9 8 6 6 6 6 6 6 6 6 6 6 6 6 6 6 6 14 2
2 2 2 2 2 2 2 2 2 2 2 2 2 2 2 2 2 2 2 2

2 2 2 2 2 6 6 2 2 2 2 2 2 2 2 2 2 2 2 2
2 14 6 6 6 6 2 8 6 6 6 6 6 6 6 6 6 6 6 2
2 14 6 2 6 2 7 6 6 6 6 6 6 6 6 6 6 2 6 2
2 14 6 6 2 2 6 6 6 6 6 6 6 6 6 6 2 6 6 2
2 14 6 6 6 2 2 2 6 6 6 6 6 6 6 2 6 6 6 2
2 2 2 2 6 6 6 2 2 2 6 6 6 6 2 2 6 6 14 2
2 2 2 2 2 14 6 6 6 2 2 2 6 6 2 6 6 6 6 2
2 2 2 2 2 14 6 6 6 6 6 6 6 2 6 6 6 6 6 2
2 2 2 2 2 14 6 6 6 6 6 6 2 8 6 6 6 6 6 2
2 2 2 2 2 2 2 2 2 2 2 2 2 6 2 2 2 2 2 2

2 2 2 2 2 2 2 2 2 2 2 2 2 2 2 2 2 2 2 2
2 6 6 6 6 6 6 6 6 6 6 6 6 6 6 6 8 8 8 2
2 6 6 6 6 6 6 6 6 2 2 6 6 6 6 6 8 8 8 2
2 6 6 6 6 6 6 6 2 2 2 2 6 6 6 6 8 8 8 2
2 6 6 6 6 6 6 2 2 2 2 2 2 6 6 6 6 6 6 2
2 6 6 6 6 6 2 2 2 2 2 2 2 2 6 6 6 6 6 2
2 6 6 6 6 2 2 2 2 2 2 2 2 2 2 6 6 6 6 2
2 6 6 6 2 2 2 2 2 2 2 2 2 2 2 2 6 6 6 2
2 6 6 2 2 2 2 2 2 2 2 2 2 2 2 2 2 6 9 2
2 6 2 2 2 2 2 2 2 2 2 2 2 2 2 2 2 2 2 2

2 6 2 2 6 6 2 2 2 2 2 2 2 2 2 2 2 2 2 2
2 8 6 1 6 6 8 6 6 6 6 14 6 6 6 6 1 11 8 2
2 6 14 0 0 0 0 0 0 0 0 0 0 6 0 0 0 14 6 2
2 6 6 0 3 3 3 13 3 3 3 3 0 6 0 15 0 6 6 2
2 6 6 0 3 13 3 3 3 5 3 3 12 3 0 3 0 6 6 2
2 6 6 0 13 0 0 0 0 0 0 0 0 0 0 13 0 6 6 2
2 6 6 0 13 3 3 3 3 3 3 3 3 3 3 13 0 6 6 2
2 14 6 0 0 0 0 0 0 0 0 0 0 0 0 0 0 14 6 2
2 6 14 6 6 6 6 6 6 9 6 6 14 6 6 6 6 6 6 2
2 2 2 2 2 2 2 2 2 2 2 2 2 2 2 2 2 2 2 2

2 2 2 2 2 2 2 2 2 2 2 2 2 2 2 2 2 2 2 2
2 2 2 2 2 2 6 6 6 6 14 6 6 6 6 6 6 6 6 6
2 2 2 2 2 14 6 2 2 2 2 2 2 2 2 2 2 2 6 2
2 2 2 2 14 6 6 6 6 6 6 6 6 2 2 2 2 2 6 2
2 2 2 14 6 6 2 2 2 2 2 2 6 2 2 2 6 6 6 2
2 2 2 14 6 6 2 2 2 2 2 2 6 2 2 2 6 2 2 2
2 2 2 14 6 6 2 2 2 2 2 2 8 6 6 6 6 2 6 6
2 2 2 2 14 6 2 2 2 2 2 2 2 2 2 2 2 2 6 2
2 2 2 2 2 6 6 6 6 6 14 6 6 6 6 6 6 6 6 2
2 2 2 2 2 2 2 2 2 2 2 2 2 2 2 2 2 2 2 2

2 2 2 2 2 2 2 2 2 2 2 2 2 6 2 2 2 2 2 2
6 6 6 6 6 6 6 6 6 6 6 6 6 6 6 6 6 6 6 2
2 2 6 6 6 6 6 6 6 6 6 6 6 6 6 6 6 6 6 2
2 2 2 6 6 6 6 6 6 6 6 6 6 6 6 6 6 6 8 2
2 2 2 2 2 2 2 2 2 2 2 2 2 2 2 2 2 2 2 2
2 6 6 6 6 6 6 6 6 6 6 6 6 6 6 6 6 6 6 2
6 6 6 6 6 6 6 6 6 6 6 6 6 6 6 6 6 6 7 2
2 2 2 2 2 2 2 2 2 2 2 1 6 6 6 1 1 1 1 1
2 2 2 2 2 2 2 2 2 2 2 1 6 6 6 1 2 2 2 2
2 2 2 2 2 2 2 2 2 2 2 1 6 6 6 1 2 2 2 2

1 17 1 1 1 1 1 1 1 1 1 1 1 1 1 1 1 1 1 1
2 6 6 6 6 6 14 6 6 6 6 6 6 6 6 2 2 2 2 2
2 6 6 6 6 6 2 14 6 6 6 6 6 6 6 6 2 2 2 2
2 2 6 6 6 6 2 6 14 6 6 6 6 6 6 6 6 2 2 2
2 2 2 6 6 6 2 2 6 14 6 6 6 6 6 6 6 6 2 2
2 2 2 6 6 6 6 2 6 6 14 6 6 6 6 6 6 6 2 2
2 2 2 2 6 6 6 2 2 2 2 2 2 2 2 2 14 6 2 2
2 2 2 2 6 6 6 6 2 2 6 6 6 6 6 6 6 14 2 2
2 2 2 2 2 14 6 6 2 2 6 6 6 6 6 6 6 2 2 2
2 2 2 2 2 6 6 6 2 2 6 6 2 2 2 2 2 2 2 2

2 2 2 2 2 2 2 2 2 2 2 2 2 2 2 2 2 2 2 2
2 2 6 6 6 6 6 6 6 14 6 6 6 6 6 6 6 6 6 2
2 2 6 2 2 2 2 2 2 2 2 2 2 2 2 2 2 14 6 2
2 2 6 6 11 6 6 6 6 6 6 2 2 2 2 2 2 14 6 2
2 2 14 2 2 2 2 2 2 2 6 6 6 6 6 6 6 6 6 6
2 2 6 6 6 14 6 6 6 2 2 2 2 2 2 2 2 6 6 6
2 2 6 2 2 2 2 2 8 6 14 6 6 6 6 6 6 6 6 6
2 2 6 2 2 2 2 2 2 2 2 2 2 2 2 2 2 14 6 2
2 2 6 6 6 6 6 14 6 6 6 6 6 6 6 6 6 6 6 2
2 2 2 2 2 2 2 2 2 2 2 2 2 2 2 2 2 2 2 2

2 2 2 2 2 2 2 2 2 2 2 2 2 2 2 2 2 2 2 2
2 2 2 2 6 6 1 6 1 8 1 8 1 7 1 7 1 14 2 2
2 2 2 6 6 6 1 14 1 6 1 6 1 6 1 6 1 6 2 2
2 2 6 6 2 6 1 14 1 6 1 6 1 6 1 6 1 6 2 2
6 6 6 2 2 6 1 6 1 14 1 6 1 6 1 6 1 6 2 2
6 6 2 2 2 6 1 6 1 6 1 14 1 6 1 6 1 6 1 1
6 2 2 2 2 6 6 6 6 6 6 6 6 6 6 6 6 14 6 6
2 2 2 2 2 6 6 6 6 6 6 6 6 6 6 14 6 6 2 2
2 2 2 2 2 6 6 6 6 6 6 14 6 6 6 6 6 2 2 2
2 2 2 2 2 2 6 6 6 6 2 2 2 2 2 2 2 2 2 2

2 2 2 2 2 2 2 2 2 2 2 1 6 6 6 2 2 2 2 2
2 2 2 2 2 2 2 2 2 2 2 1 6 6 6 6 6 6 14 2
2 2 2 2 2 1 1 1 1 1 1 1 1 1 1 1 1 14 6 2
2 2 2 1 1 1 6 6 6 6 6 14 6 6 6 6 1 6 6 2
2 2 1 1 6 6 6 6 6 0 0 0 14 6 6 6 1 6 6 2
1 1 1 6 6 6 8 0 0 0 0 0 6 14 6 6 1 6 6 2
6 6 6 6 6 6 0 0 0 0 0 0 6 6 14 6 1 6 6 2
2 6 6 6 6 6 0 6 6 6 6 0 6 6 6 14 1 6 6 2
2 6 6 6 6 6 6 6 6 6 6 6 6 6 6 6 14 6 6 2
1 1 17 1 1 1 1 1 1 1 1 1 1 1 1 1 1 1 1 1

2 2 2 2 2 6 6 6 2 2 6 6 2 2 2 2 2 2 2 2
2 2 2 2 2 6 6 6 2 2 6 6 6 6 6 6 14 6 6 6
2 2 2 2 2 6 6 6 2 2 2 2 2 2 2 2 2 2 2 2
2 2 2 2 2 6 6 6 6 2 2 2 6 6 6 6 6 14 6 6
2 2 2 6 6 6 6 6 6 6 2 2 6 6 6 6 6 2 2 2
2 2 6 6 2 2 6 6 6 6 6 2 6 6 6 6 6 2 2 2
2 2 6 2 2 2 2 6 6 6 6 2 6 6 6 6 6 2 2 2
2 2 14 2 2 2 2 6 6 6 6 2 6 6 6 6 6 2 2 2
2 2 7 2 2 2 2 6 6 14 6 6 6 6 6 6 6 6 6 6
2 2 2 2 2 2 2 2 2 2 2 2 2 2 2 2 2 2 2 2

2 2 2 2 2 2 2 2 2 2 2 2 2 2 2 2 2 2 2 2
6 6 6 6 6 6 6 14 6 6 6 6 6 6 6 6 6 6 6 2
2 2 2 2 2 2 2 2 2 2 2 2 2 14 6 6 6 6 6 6
6 6 6 6 6 6 6 6 6 6 6 6 2 2 2 2 6 6 6 2
2 2 2 2 2 2 2 2 2 2 2 6 6 6 6 2 2 2 2 2
2 2 2 2 2 2 2 2 2 2 2 6 14 6 6 6 6 6 6 6
2 2 2 2 2 2 2 2 2 2 2 8 6 6 2 2 2 2 2 2
2 2 2 2 2 2 2 2 2 2 2 6 6 6 6 6 6 6 6 6
6 6 6 6 6 6 14 6 6 6 6 6 6 6 6 6 6 6 6 2
2 2 2 2 2 2 2 2 2 2 2 2 2 2 2 2 2 2 2 2

2 2 2 2 2 2 6 6 6 6 2 2 2 2 2 2 2 2 2 2
2 6 6 6 6 6 6 6 6 6 2 2 2 2 2 2 2 2 2 2
6 6 6 6 6 6 6 14 6 2 2 2 2 2 2 2 2 2 9 2
2 8 6 6 6 6 2 2 2 2 2 2 2 2 2 2 2 8 6 2
2 2 2 2 2 2 2 2 2 2 2 2 2 2 2 2 6 6 6 2
6 6 6 6 6 6 6 6 6 6 6 6 6 2 2 6 6 6 6 2
2 2 2 2 2 6 6 6 6 6 6 6 6 2 6 6 6 6 6 2
6 6 6 6 6 2 2 2 2 2 6 6 6 6 6 6 6 6 6 2
2 2 6 6 6 6 6 6 6 6 2 2 2 2 2 6 14 6 6 2
2 2 2 2 2 2 2 2 2 6 2 2 2 2 2 2 2 2 2 2

1 1 17 1 1 1 1 1 1 1 1 1 1 1 1 1 1 1 1 1
2 2 6 6 6 6 6 6 6 6 6 14 6 6 6 6 6 6 6 2
2 2 6 6 6 6 6 6 6 6 6 6 14 6 6 6 6 6 6 2
2 2 14 6 6 1 1 1 1 1 1 1 1 1 1 1 6 6 6 2
2 2 2 14 6 6 1 2 2 6 6 6 6 6 7 1 6 6 6 2
2 2 2 2 14 6 6 1 2 6 6 6 6 6 6 1 6 6 6 2
2 2 2 2 2 14 6 6 1 6 6 6 6 6 6 1 6 6 6 2
2 6 6 6 6 6 14 6 6 6 6 6 6 6 6 1 6 6 6 2
2 6 6 6 6 6 6 14 6 6 6 6 6 6 6 1 6 6 6 2
2 2 2 2 2 2 2 2 2 2 2 2 2 6 6 1 6 6 6 2

2 2 2 2 2 2 2 2 2 2 2 2 2 2 2 2 2 2 2 2
2 2 7 2 2 2 2 6 6 6 6 6 6 6 6 14 6 6 6 2
2 2 6 2 2 2 2 6 6 14 6 6 6 6 6 6 6 6 6 6
2 2 6 2 2 2 2 6 6 6 6 6 14 6 6 6 6 6 6 6
2 6 6 6 6 6 6 14 6 6 6 6 6 6 6 6 6 6 6 2
2 6 14 2 2 2 2 2 2 2 2 2 2 2 2 2 2 2 2 2
2 2 6 6 6 6 6 6 6 14 6 6 6 6 8 2 2 2 2 2
2 14 6 2 2 2 2 2 2 2 2 2 2 2 2 2 6 6 6 6
2 6 6 6 6 6 6 6 6 6 6 14 6 6 6 6 6 6 2 2
2 2 2 2 2 2 2 2 2 2 2 2 2 2 2 2 2 2 2 2

2 2 2 2 2 2 2 2 2 2 2 2 2 2 2 2 2 2 2 2
2 2 2 2 2 2 2 2 2 2 2 2 2 2 2 2 2 2 2 2
6 6 6 6 14 2 2 2 2 2 8 6 6 2 2 2 2 6 6 6
6 6 6 6 6 6 6 6 6 14 6 6 6 6 6 6 6 6 6 6
2 2 6 6 6 6 6 6 6 6 6 6 6 6 6 6 6 14 6 6
2 2 2 2 2 2 2 2 2 2 2 2 2 2 2 2 2 2 2 2
2 2 2 2 2 2 2 2 8 6 6 6 2 2 2 2 2 2 2 2
6 6 6 6 6 6 6 6 6 2 2 6 6 6 14 6 6 6 6 6
2 2 2 2 2 2 2 2 2 2 2 2 2 2 2 2 2 2 2 2
2 2 2 2 2 2 2 2 2 2 2 2 2 2 2 2 2 2 2 2

2 2 2 2 2 2 2 2 2 6 2 2 2 2 2 2 2 2 2 2
2 6 6 6 6 14 6 6 6 6 6 6 6 6 6 6 6 6 8 2
6 6 6 6 6 6 6 6 6 6 6 6 6 6 6 6 14 6 6 2
6 6 6 6 6 2 2 2 2 2 2 2 2 2 2 2 2 2 2 2
6 6 6 6 2 2 6 6 6 6 6 14 6 6 6 6 6 2 7 2
2 2 2 2 2 2 6 2 2 2 2 2 2 2 2 2 6 2 6 6
2 2 2 2 2 6 6 2 14 6 6 6 6 6 6 6 6 2 6 2
6 6 6 6 6 6 6 2 14 2 2 2 2 2 2 2 2 2 6 2
2 2 6 6 6 6 6 2 6 6 6 6 6 6 6 14 6 6 6 2
2 2 2 2 2 2 2 2 2 2 2 2 2 2 2 2 2 2 2 2

2 2 2 2 2 2 2 2 2 2 2 2 2 6 6 1 14 6 6 2
2 2 6 6 6 6 14 6 6 6 6 8 6 6 6 1 6 6 6 2
2 2 6 2 2 2 2 2 2 2 2 2 2 2 2 1 14 6 6 2
2 2 6 2 1 1 1 1 1 1 1 1 1 1 1 1 6 6 14 2
2 2 14 2 1 8 6 6 6 6 6 6 6 6 6 6 6 6 6 2
6 6 14 2 1 6 6 6 6 6 6 6 6 6 6 6 6 6 6 2
2 2 2 2 1 6 6 6 6 6 6 6 6 6 6 6 6 6 14 2
2 1 1 1 1 6 6 6 6 6 6 6 6 6 6 6 6 6 14 2
2 16 6 6 6 6 8 6 6 6 6 8 6 6 6 6 6 6 6 2
2 2 2 2 2 2 2 2 2 2 2 2 2 2 2 2 2 2 2 2
