1 1 1 1
1 0 0 0
0 0 0 0
0 0 0 0
0 0 0 0
1 1 1 1

2 2 2 2 2 2 2 2 2 2 2 2 2 2 2 2 2 2 2 2 
2 6 6 6 6 6 6 6 6 6 6 6 6 6 6 6 6 6 6 6
2 6 6 6 14 6 6 6 6 6 6 6 6 6 6 6 6 6 6 2
2 6 14 6 6 6 6 2 2 2 6 2 2 2 2 6 6 6 6 2
2 6 6 6 6 6 6 2 6 6 6 6 6 6 2 6 6 6 6 2
2 6 6 2 2 2 2 2 6 6 14 6 6 6 2 2 6 6 6 2
2 6 6 2 6 6 6 6 6 6 6 6 6 6 2 2 6 6 6 2
2 6 6 2 6 6 6 6 6 6 6 6 6 14 6 2 2 2 6 2
2 6 6 2 8 6 14 6 6 8 6 6 6 6 6 6 8 2 6 2
2 6 6 2 2 2 2 2 2 2 2 2 2 2 2 2 2 2 2 2

2 2 2 2 2 2 2 2 2 2 2 2 2 2 2 2 2 2 2 2
6 6 6 6 6 2 2 2 2 2 2 2 2 2 2 2 2 2 2 2
2 2 2 6 6 6 6 6 14 6 6 6 6 6 6 6 6 6 6 6
2 2 2 2 6 6 6 6 6 6 6 6 6 6 14 6 6 6 6 6
2 2 2 2 2 2 2 2 2 2 2 2 2 2 2 2 2 2 2 2
2 7 6 14 6 6 6 6 6 6 6 6 6 6 6 6 14 6 6 2
2 2 6 6 6 6 6 6 0 14 6 0 6 14 6 6 6 6 6 6
2 2 2 2 2 2 2 0 1 3 3 1 0 2 2 2 2 2 2 2
2 2 2 2 2 2 2 0 1 3 3 1 0 2 2 2 2 2 2 2
2 2 2 2 2 2 2 0 1 3 3 1 0 2 2 2 2 2 2 2

2 2 2 2 2 2 2 2 2 2 2 2 2 2 2 2 2 2 2 2
2 6 6 6 6 6 6 6 6 6 6 2 2 2 2 8 14 6 6 2
6 6 6 2 2 2 6 14 6 6 6 6 6 6 2 6 6 6 6 2
6 6 6 6 6 6 6 6 6 6 6 6 6 6 2 2 2 2 6 2
2 2 2 2 2 2 2 2 2 6 6 6 6 6 6 6 6 6 6 6
2 2 2 2 2 2 2 2 2 2 6 6 6 6 6 6 6 6 2 2
6 6 14 6 6 6 6 6 6 2 2 2 2 2 2 2 2 2 2 2
2 2 2 2 2 6 6 6 6 6 6 6 6 6 6 6 6 6 6 6
2 2 2 2 2 2 2 14 6 6 6 6 6 6 6 6 6 6 6 6
2 2 2 2 2 2 2 2 2 2 2 2 2 2 2 2 2 2 2 2

2 2 2 2 2 2 2 2 2 2 2 2 2 2 2 2 2 2 2 2
2 6 6 6 6 6 6 6 6 6 6 6 6 6 6 6 6 6 6 2
2 6 6 6 6 14 6 6 6 6 6 6 14 6 6 6 6 6 6 2
2 6 6 6 6 6 6 6 6 14 6 6 6 6 6 6 6 6 6 2
6 6 6 6 6 6 6 6 6 6 6 6 6 6 6 6 6 6 6 2
2 2 2 2 2 2 2 2 2 2 2 2 2 2 2 2 2 6 6 2
2 2 2 2 2 2 2 2 2 2 2 2 2 2 2 2 6 6 6 2
6 6 6 6 6 14 6 6 6 6 6 6 6 6 6 6 6 6 6 2
6 6 6 6 6 6 6 6 6 6 6 6 14 6 6 6 6 6 6 2
2 2 2 2 2 2 2 2 2 2 2 2 2 2 2 2 2 2 2 2

2 6 6 2 2 2 2 2 2 2 2 2 2 2 2 2 2 2 2 0
2 6 6 2 2 2 2 2 2 2 2 2 2 2 2 2 2 2 2 0
2 6 6 6 6 2 2 2 2 2 2 2 2 2 2 2 2 2 2 0
2 2 8 8 6 6 6 14 14 6 6 8 8 6 6 6 6 6 6 0
2 2 2 2 6 14 6 6 6 6 6 6 2 2 2 2 2 2 2 0
2 2 2 2 14 6 6 6 6 14 2 2 2 2 6 6 14 6 6 0
2 6 6 14 6 6 6 6 6 6 6 14 6 6 6 6 6 6 6 0
2 6 14 6 6 6 16 6 6 6 6 6 6 6 14 6 6 6 6 0 
2 6 14 6 6 6 6 6 6 6 6 6 14 6 6 6 14 6 6 0
2 6 2 2 2 2 2 2 2 2 2 2 2 2 2 2 2 2 2 0

0 0 0 0 0 0 0 0 1 3 3 1 0 0 0 0 0 0 0 0 
0 3 3 3 3 3 3 3 3 3 3 3 3 3 3 3 3 3 3 0
0 3 3 3 3 3 3 3 3 13 3 3 3 3 3 3 3 3 3 0
0 3 3 3 3 3 3 3 3 3 3 3 3 3 3 3 3 3 3 0
0 3 3 3 3 3 3 1 1 1 1 1 3 3 3 3 3 13 3 12
0 13 3 3 3 3 3 1 5 3 3 3 3 3 3 3 3 3 3 0
0 3 3 3 3 3 3 1 3 3 3 3 3 3 3 3 3 3 3 0
0 3 13 3 3 3 3 1 3 3 3 13 3 3 9 3 3 3 3 0
0 3 3 3 1 1 1 1 3 3 3 3 13 3 3 3 3 3 3 0
0 3 3 0 0 0 0 0 0 0 0 0 0 0 0 0 0 0 0 0

0 0 0 0 0 0 0 0 0 0 0 0 0 0 0 0 0 0 0 0 
0 3 3 3 3 3 3 3 3 3 3 3 3 3 3 3 3 3 3 3
0 3 13 3 3 3 3 3 3 13 3 3 3 3 13 3 3 13 3 3
0 1 1 1 13 1 1 3 13 3 3 3 13 3 3 13 3 3 1 0
3 3 3 3 3 1 3 3 3 3 3 13 13 3 3 3 3 13 1 0
0 1 1 1 3 1 3 3 13 3 13 3 3 3 3 13 3 13 1 0
0 3 3 1 3 1 3 3 3 3 3 3 3 13 3 3 3 3 1 0
0 3 3 1 3 1 3 3 13 3 13 3 3 3 3 3 13 3 1 0
0 3 3 3 3 1 3 3 3 3 3 3 3 3 9 3 3 3 1 0
0 0 0 0 0 0 0 0 0 0 0 0 0 0 0 0 0 0 0 0

0 0 0 0 0 0 0 0 0 0 0 0 0 0 0 0 0 0 0 0
3 3 3 17 4 3 3 3 3 3 3 3 3 3 3 3 3 3 3 0 
3 3 3 1 4 3 3 3 3 13 3 3 3 3 3 3 3 3 3 0
0 3 3 1 1 1 1 5 3 3 3 3 3 13 3 3 3 3 3 0
0 3 3 3 3 3 1 5 3 3 13 3 3 3 3 3 3 3 3 0
0 3 13 3 3 3 1 5 13 3 3 3 3 3 3 3 3 13 3 0
0 3 3 3 13 3 1 1 1 1 3 3 3 3 13 3 3 3 3 0
0 3 3 3 3 3 3 3 3 1 3 3 3 3 3 3 3 3 3 0
0 3 3 3 3 3 13 3 3 1 3 3 3 3 3 3 3 3 3 0
0 0 0 0 0 0 0 3 3 0 0 0 0 0 3 3 0 0 0 0 

0 6 0 0 0 0 0 0 0 0 0 0 0 0 0 0 0 0 0 0
0 6 3 10 3 13 3 3 3 3 3 3 3 3 1 3 3 3 5 0 
0 6 3 9 3 3 3 3 3 3 3 13 3 3 1 3 3 3 3 0
0 6 1 1 1 1 1 3 1 1 1 1 1 1 1 3 1 1 1 0
0 6 3 3 13 3 3 3 3 13 3 3 3 3 3 3 3 3 3 3
0 6 3 3 3 3 3 13 3 3 3 13 3 13 3 3 3 3 3 3
0 6 1 1 1 1 1 1 1 3 1 1 1 1 1 1 1 1 1 0
0 6 3 3 3 3 3 3 3 3 3 3 3 3 3 3 3 3 3 0
0 6 5 3 13 3 3 3 13 3 3 3 3 3 13 3 3 3 3 0
0 6 0 0 0 0 0 0 0 0 0 0 0 0 0 0 0 0 0 0

0 3 3 0 0 0 0 0 0 0 0 0 0 0 0 0 0 0 0 0
0 3 3 1 3 3 3 3 3 3 3 3 3 3 3 3 3 3 3 0
0 3 3 1 3 13 3 3 3 3 3 13 3 3 13 3 3 3 3 0
0 3 3 1 3 3 3 3 3 13 3 3 3 3 3 13 3 3 3 0
3 3 3 3 3 13 3 13 3 3 3 3 3 3 3 3 3 3 3 0
3 3 3 1 1 1 1 1 3 3 3 3 13 3 3 3 13 3 3 0
0 3 3 1 4 3 3 1 3 3 3 3 3 3 13 13 3 3 3 0
0 3 3 1 3 3 3 3 3 13 3 13 3 3 3 3 3 3 3 0
0 3 3 1 3 3 3 3 3 3 3 3 13 3 3 3 3 3 3 0
0 3 3 0 0 0 0 0 0 0 0 0 0 0 0 0 0 0 0 0

0 0 0 0 0 0 0 0 0 0 0 0 0 0 0 0 0 0 0 0
0 9 3 3 3 3 3 3 3 3 3 3 3 3 3 3 3 3 3 0
0 3 3 3 13 3 3 3 3 3 3 13 3 13 3 3 3 3 3 0
0 3 13 3 3 3 3 13 3 3 3 3 3 3 3 3 3 3 3 0
0 3 3 3 13 3 3 3 3 3 13 3 13 3 3 3 3 3 3 3
0 3 13 3 3 3 3 3 3 3 3 3 3 3 3 3 3 3 3 3
0 3 3 3 3 3 13 3 3 13 3 3 3 13 3 3 3 3 3 0
0 3 3 13 3 13 3 3 3 3 3 13 3 3 3 3 3 3 3 0
0 3 3 3 3 3 3 13 3 3 3 3 3 3 13 3 3 3 3 0
0 0 0 0 0 0 0 0 0 0 0 0 0 0 0 0 0 0 0 0

0 0 0 0 0 0 0 3 3 0 0 0 0 0 3 3 0 0 0 0
0 13 3 3 3 3 1 3 3 1 3 3 3 3 3 13 3 3 3 0 
0 3 3 3 3 3 1 3 3 1 3 3 3 3 3 3 3 3 3 0
0 1 1 1 1 3 3 3 3 3 3 3 13 3 3 13 3 3 3 0
3 3 3 3 1 3 3 3 3 3 1 1 1 1 1 3 3 3 3 0
3 3 13 3 1 1 3 3 3 3 1 3 3 3 3 3 3 3 3 0
0 3 13 3 3 1 3 3 3 3 1 3 3 1 1 1 1 3 3 0
0 3 3 3 3 1 1 1 1 1 1 3 3 1 13 3 3 3 3 0
0 13 3 3 3 3 3 3 3 3 3 3 3 1 1 3 3 3 3 0
0 0 0 0 0 0 0 0 0 0 0 0 0 0 0 3 0 0 0 0

0 6 0 0 0 0 0 0 0 0 0 0 0 0 0 0 0 0 0 0
0 6 3 1 3 3 3 3 3 3 3 3 3 3 3 3 3 4 10 0
0 6 3 1 3 3 3 3 3 13 3 3 3 3 3 3 3 3 3 0
0 6 3 1 3 13 3 1 3 3 3 3 3 13 3 3 3 3 3 0
0 6 3 3 3 3 3 1 3 3 3 3 3 3 3 3 3 3 3 0
0 6 3 3 3 3 3 1 3 3 3 3 1 1 1 1 1 13 3 0
0 6 3 1 13 3 3 1 3 3 3 3 1 1 1 1 1 3 3 0
0 6 3 1 3 3 3 3 3 3 3 3 1 1 1 1 1 3 13 0
0 6 3 1 3 3 3 3 3 3 3 3 3 3 3 3 3 3 3 0
0 6 0 0 3 3 0 0 0 0 0 0 0 0 0 0 0 0 0 0

0 3 3 0 0 0 0 0 0 0 0 0 0 0 0 0 0 0 0 0
0 3 3 3 3 3 3 3 3 3 3 3 3 3 3 3 3 3 3 0
0 1 3 3 3 13 3 3 13 3 3 3 3 3 3 13 3 3 3 0
0 1 1 1 1 3 3 3 3 3 3 3 3 3 3 3 3 3 3 3
0 3 3 9 1 1 1 1 1 13 3 3 3 3 13 3 13 3 3 3
0 3 3 3 3 3 3 3 1 3 3 13 3 3 3 3 3 3 3 0
0 3 13 3 3 13 3 3 1 13 3 3 13 3 13 3 3 13 3 0
0 3 3 3 3 3 3 3 1 3 3 3 3 3 3 3 3 3 3 0 
0 3 3 13 3 3 3 13 1 3 3 3 3 3 3 3 3 3 5 0
0 0 3 3 0 0 0 0 0 0 0 0 0 0 0 0 0 0 0 0

0 0 0 0 0 0 0 0 0 0 0 0 0 0 0 0 0 0 0 0
0 5 3 13 3 3 3 3 3 3 3 3 3 3 3 3 3 3 4 0
0 1 1 1 1 1 3 3 3 3 3 3 3 13 3 3 3 3 3 0
3 3 3 3 5 1 3 13 3 3 3 3 3 3 3 13 3 3 3 0
3 3 3 13 3 1 3 3 3 3 3 3 3 13 3 3 13 3 3 3
0 3 3 3 3 1 1 1 1 1 1 3 3 3 3 3 3 3 3 3
0 13 3 3 3 3 1 5 3 3 3 3 3 3 3 3 3 3 3 0
0 3 3 13 3 3 1 3 3 3 3 3 3 3 3 13 3 3 3 0
0 9 3 3 3 3 1 3 3 13 3 3 3 3 3 3 3 13 3 0
0 0 0 0 0 0 0 0 0 3 3 0 0 0 0 0 0 0 0 0

0 0 0 0 0 0 0 0 0 0 0 0 0 0 0 3 0 0 0 0  
0 3 1 3 3 3 3 3 3 3 13 3 3 3 3 3 3 3 3 0
0 3 3 13 1 3 3 3 3 3 3 3 3 3 3 3 3 3 3 0
0 3 1 1 1 1 1 1 1 1 3 3 1 3 1 3 1 3 3 0
3 3 1 5 13 3 3 3 5 1 3 3 3 3 1 3 3 3 3 0
3 3 1 3 3 3 3 3 3 1 3 3 1 1 13 3 1 3 3 0
0 1 1 3 3 3 3 3 3 1 3 3 3 3 1 3 3 3 3 0
0 4 3 3 3 13 3 3 3 1 3 13 1 3 1 3 1 3 3 0
0 3 3 3 3 3 3 3 3 1 3 3 3 3 3 3 13 3 3 0
0 3 3 0 0 0 0 0 0 0 0 0 0 0 0 0 0 0 0 0

0 6 0 0 3 3 0 0 0 0 0 0 0 0 0 0 0 0 0 0
0 13 3 3 3 3 3 3 3 3 3 3 3 3 3 3 3 3 13 0
0 3 3 1 1 1 3 3 1 1 1 3 1 1 1 1 3 1 3 0
0 3 3 1 3 3 1 3 3 1 3 3 1 3 3 3 3 1 3 0
0 3 3 1 3 3 1 3 3 1 3 3 1 1 1 3 3 1 3 0
0 3 3 1 3 3 1 3 3 1 3 3 1 1 1 3 3 1 3 0
0 3 3 1 3 3 1 3 3 1 3 3 1 3 3 3 3 3 3 3
0 3 3 1 1 1 3 3 1 1 1 3 1 1 1 1 3 1 3 0
0 13 3 3 3 3 3 3 3 3 3 3 3 3 3 3 3 3 13 0  
0 12 0 0 0 0 0 0 0 0 0 0 0 0 0 0 0 0 0 0

0 0 3 3 0 0 0 0 0 0 0 0 0 0 0 0 0 0 0 0
0 3 3 3 3 3 3 3 3 3 3 3 3 3 3 3 3 3 5 0
0 3 3 3 3 3 3 3 3 3 3 3 3 3 3 3 3 3 3 0
0 3 3 3 3 3 3 3 3 3 3 3 13 3 3 3 3 3 3 0
0 3 13 3 3 13 3 3 13 3 3 3 3 3 3 3 3 3 5 3
0 3 3 3 3 3 3 3 3 3 3 3 3 3 3 3 3 3 5 3
12 3 3 3 3 3 3 3 3 3 13 3 3 13 3 3 3 3 3 0
0 3 3 3 3 3 13 3 3 3 3 3 3 3 3 3 3 3 3 0
0 3 3 3 3 3 3 3 3 3 3 3 3 3 3 3 3 3 5 0
0 0 0 0 0 0 0 0 0 0 0 0 0 0 0 0 0 0 0 0

0 0 0 0 0 0 0 0 0 3 3 0 0 0 0 0 0 0 0 0
0 0 0 0 0 0 0 0 0 3 3 0 0 0 0 0 0 0 0 0
0 0 0 0 0 0 0 0 0 3 3 0 0 0 0 0 0 0 0 0
0 0 0 0 0 0 0 0 0 3 3 0 0 0 0 0 0 0 0 0
3 3 3 3 13 3 3 3 3 3 3 3 3 3 3 3 13 3 3 3
3 3 3 3 3 3 3 3 3 3 3 3 3 3 13 3 3 3 3 3
0 0 0 0 0 0 0 0 0 13 3 0 0 0 0 0 0 0 0 0
0 0 0 0 0 0 0 0 0 3 3 0 0 0 0 0 0 0 0 0
0 0 0 0 0 0 0 0 0 3 5 0 0 0 0 0 0 0 0 0
0 0 0 0 0 0 0 0 0 3 3 0 0 0 0 0 0 0 0 0

0 3 3 0 0 0 0 0 0 0 0 0 0 0 0 0 0 0 0 0
0 3 3 3 3 3 3 3 3 3 3 3 3 3 3 3 3 3 3 0
0 3 3 3 3 3 3 3 3 3 3 3 13 3 3 3 3 3 3 0
0 1 1 1 1 1 1 1 3 3 3 3 3 3 13 3 3 3 3 0
3 3 3 3 3 3 5 1 1 3 3 3 3 3 3 13 3 3 3 0
3 3 3 3 3 3 3 3 1 1 3 3 3 3 3 3 13 3 3 0
0 3 3 3 3 3 3 3 3 1 1 1 1 3 3 3 3 13 3 0
0 3 3 3 3 3 3 3 3 3 3 3 3 3 3 3 3 3 13 0
0 3 3 3 3 3 3 3 3 3 3 3 3 3 3 3 3 3 3 0
0 0 0 0 0 0 0 0 0 0 0 0 0 0 0 0 0 0 0 0

0 3 0 0 2 2 2 2 2 2 2 2 2 2 2 2 2 2 2 2
2 3 6 6 6 6 6 6 6 6 8 6 6 6 14 6 6 6 6 2
2 6 6 6 6 6 6 6 6 6 6 6 6 6 6 6 6 6 14 2
2 6 6 6 6 6 2 6 6 6 6 6 6 2 2 2 2 2 2 2
2 6 6 6 6 6 2 2 2 2 2 2 2 2 14 6 6 6 6 2
2 6 6 6 6 6 6 6 6 6 6 6 6 6 6 6 6 6 7 2
2 6 6 6 6 6 2 2 2 2 2 2 2 2 8 6 6 6 6 2
2 14 6 6 6 14 6 6 6 6 6 6 6 2 2 2 2 2 2 2
2 6 6 6 6 6 6 6 6 6 6 6 6 6 6 6 6 6 14 6
2 2 2 2 2 2 2 2 2 2 2 2 2 2 2 2 2 2 2 2

2 2 2 2 2 2 2 2 2 2 2 2 2 2 2 2 2 2 2 2
2 8 6 6 6 6 14 6 6 6 6 6 6 6 6 6 6 2 6 6
2 2 2 2 2 6 6 6 6 6 2 6 6 14 6 6 6 2 6 2
2 8 6 6 6 6 6 6 6 6 7 2 6 6 6 14 6 2 6 2
2 2 2 2 2 14 6 2 2 2 2 2 2 6 6 6 6 2 6 2
2 6 14 6 6 6 6 6 6 14 6 2 6 6 6 6 6 2 14 2
2 6 6 6 6 6 6 6 6 6 2 6 6 6 6 6 6 2 6 2
2 6 6 6 6 6 6 6 6 6 6 6 6 6 6 6 6 2 6 2
6 6 6 6 6 14 6 6 6 6 6 14 6 6 6 6 6 6 6 2
2 2 2 2 2 2 2 2 2 2 2 2 2 2 2 2 2 2 2 2

2 2 2 2 2 2 0 0 0 3 3 0 0 0 2 2 2 2 2 2 
6 6 6 6 2 2 2 6 6 6 6 2 14 6 6 2 6 8 6 2
2 6 6 6 2 6 6 6 6 6 6 2 6 6 6 11 2 6 6 6
2 14 6 9 2 6 6 2 6 6 6 2 6 6 6 6 2 6 6 6
2 6 6 2 2 6 6 2 6 6 6 2 6 6 2 2 2 6 14 2
2 6 6 2 6 6 14 2 8 6 6 2 6 2 2 7 2 14 6 2
2 6 6 2 14 6 6 2 6 6 6 6 6 6 6 6 2 6 6 2
2 6 6 2 2 2 2 2 2 2 2 2 2 2 2 2 2 6 6 2
2 14 6 6 6 6 6 6 14 6 6 6 6 14 6 6 6 6 6 2
2 2 2 2 2 2 2 2 2 2 2 2 2 2 2 2 2 2 2 2

2 2 2 2 2 2 2 2 2 2 2 2 2 2 2 2 2 2 2 2
2 14 6 6 6 6 6 6 14 6 6 6 6 6 6 6 6 6 8 2
6 8 14 6 6 6 6 14 6 6 0 0 0 0 0 0 0 0 6 2
6 6 6 14 6 6 14 8 6 6 0 15 1 13 4 3 3 3 6 2
2 6 6 6 14 14 6 6 6 6 0 3 1 3 13 3 3 0 6 2
2 6 6 6 14 14 6 6 6 6 0 3 1 3 3 13 3 0 6 2
2 6 6 14 6 6 14 8 6 6 0 3 3 3 3 3 13 0 6 2
2 8 14 6 6 6 6 14 6 6 0 0 0 0 0 0 0 0 6 2
2 14 6 6 6 6 6 6 14 6 6 6 6 6 6 6 6 6 8 2
2 2 2 2 2 2 2 2 2 2 2 2 2 2 2 2 2 2 2 2