0 0 0 0
0 0 0 0
0 0 0 0
0 0 0 0
0 0 0 0
0 0 0 0

2 2 2 2 2 2 2 2 2 2 2 2 2 2 2 2 2 2 2 2
2 7 6 6 6 6 6 14 6 8 6 6 6 6 6 6 6 6 6 8
2 6 6 6 16 6 6 6 6 6 6 6 14 6 6 6 6 6 6 6
2 6 2 2 2 2 2 6 6 14 6 2 2 2 6 6 6 6 6 6
2 6 6 2 2 2 2 2 6 6 6 2 2 2 6 6 14 6 6 6
2 6 6 2 2 2 2 2 14 6 6 2 2 2 6 6 6 6 6 6
2 6 14 6 2 2 2 2 2 6 6 2 2 2 6 6 6 6 6 6
2 6 6 6 2 2 2 2 2 14 6 6 6 6 6 6 6 6 6 6
2 6 6 6 6 6 6 6 6 6 6 6 14 8 6 6 6 6 6 8
2 6 6 6 6 6 6 6 6 6 6 6 6 6 6 6 6 6 14 6

2 2 2 2 2 2 2 2 2 2 2 2 2 2 2 2 2 2 2 2
6 6 2 9 6 6 6 6 6 6 6 6 6 6 6 6 6 6 6 6
6 6 2 6 6 6 6 6 6 6 6 6 6 6 6 6 6 6 6 6
6 6 2 6 2 6 6 6 14 6 6 6 6 6 6 6 14 6 6 6
6 6 2 6 2 6 6 6 6 6 6 6 6 6 6 14 6 6 6 6
6 6 2 6 2 6 6 6 6 6 6 6 6 6 6 6 6 6 6 6
6 6 2 6 2 2 2 2 2 2 2 2 2 2 2 2 2 2 2 2
6 6 2 6 6 6 6 6 6 6 6 6 6 6 6 6 6 6 6 6
6 6 2 6 6 6 6 6 6 6 14 6 6 6 6 6 6 6 6 6
6 6 2 2 2 2 2 2 2 2 2 2 2 2 2 2 2 2 2 2

2 2 2 2 2 2 2 2 2 2 2 2 2 2 2 2 2 2 2 2
6 6 6 6 6 14 6 6 8 2 6 6 6 6 6 6 6 6 6 6
6 6 6 6 6 6 6 6 6 2 6 8 6 6 6 6 6 6 6 6
6 6 6 6 6 6 6 6 6 2 6 6 6 6 6 6 6 6 6 6
6 6 6 6 6 6 6 6 6 2 6 6 6 6 6 6 6 6 6 6
6 6 6 6 6 6 6 6 2 2 6 6 6 6 6 6 6 6 14 2
2 2 2 2 2 2 2 14 2 6 6 14 6 6 6 6 6 6 6 2
6 6 6 6 6 6 2 6 2 6 6 6 6 6 6 6 6 6 6 2
6 6 6 6 6 6 2 6 8 6 2 2 2 2 6 6 6 6 8 2
2 2 2 2 6 6 2 2 2 2 6 6 6 6 2 2 2 2 2 2

2 2 2 2 2 2 2 2 2 2 2 2 2 2 2 2 2 2 2 2
6 6 2 6 6 6 6 6 6 6 6 6 6 6 6 6 6 6 6 2
6 6 2 6 2 6 6 2 6 2 2 2 2 2 2 2 2 6 6 2
6 6 2 6 6 6 6 6 6 2 6 6 6 6 6 6 6 6 6 2
6 6 6 6 2 2 2 2 2 2 2 2 2 2 2 2 2 6 6 2
2 6 6 2 6 6 14 6 6 6 6 6 6 6 6 6 6 6 6 2
2 6 2 6 6 6 6 6 6 6 6 6 6 6 6 6 6 6 6 2
2 2 6 6 6 6 6 6 6 6 6 6 6 6 6 6 6 6 6 2
2 6 14 6 6 6 6 6 6 6 6 7 6 6 6 6 6 6 6 2
2 2 2 2 2 2 2 2 2 2 2 2 6 6 6 6 6 6 2 2

2 6 6 6 6 6 6 6 6 6 6 6 6 6 6 6 6 6 6 6
2 6 6 6 6 6 6 6 6 6 6 6 6 6 2 6 2 6 6 8
2 14 6 2 2 6 6 6 6 6 6 6 14 6 2 2 2 6 6 6
2 6 6 6 2 6 6 6 6 6 6 6 6 6 6 6 6 6 6 6
2 6 6 2 2 6 6 14 6 6 6 6 6 6 6 6 6 6 6 6
2 6 6 6 6 6 6 6 6 2 6 2 6 6 6 6 6 6 6 6
2 6 6 6 6 6 6 6 6 2 2 2 6 6 6 6 6 6 6 6
2 6 6 6 6 6 6 6 6 2 6 2 6 6 6 6 6 6 14 6
2 6 6 6 6 8 6 6 6 6 6 6 6 6 6 6 6 6 6 6
2 6 6 6 6 2 2 2 2 2 2 2 2 2 2 2 2 2 2 2

6 6 2 2 2 2 2 2 2 2 2 2 2 2 2 2 2 2 2 2
6 6 6 6 6 6 6 6 6 6 6 6 6 6 6 6 6 6 6 2
6 6 6 6 6 6 6 6 6 6 6 6 2 2 2 2 2 2 6 2
6 14 6 6 6 6 6 6 6 6 7 6 2 6 6 6 14 2 6 2
6 6 6 6 6 6 6 6 6 6 6 6 2 6 2 11 6 2 6 2
6 6 6 6 6 6 6 6 6 6 6 6 2 8 2 2 2 6 6 2
6 6 6 6 6 6 6 14 6 6 6 6 2 6 6 6 6 6 2 2
6 6 6 6 6 6 6 6 6 6 6 6 2 2 2 2 2 2 6 6
6 6 14 6 6 6 6 6 6 6 6 6 6 6 6 6 6 6 6 2
2 2 2 2 2 2 2 2 2 2 2 2 2 2 2 2 2 6 6 2

2 2 2 2 6 6 2 2 2 2 8 6 6 14 2 2 2 2 2 2
2 6 14 6 6 6 6 6 6 2 6 6 2 2 6 6 14 6 6 6
2 6 6 14 6 2 6 6 6 6 6 2 6 6 6 6 6 6 6 6
2 6 6 6 6 2 2 6 6 6 2 6 14 6 6 6 6 6 6 2
2 6 6 6 6 2 6 2 6 2 6 6 6 6 6 6 6 6 6 2
2 6 6 6 6 2 6 6 2 6 6 6 6 6 6 6 6 6 6 2
2 6 6 6 2 6 6 6 6 6 6 6 6 6 6 6 6 6 6 2
6 6 2 2 6 6 6 6 8 6 6 6 6 6 6 6 6 14 6 2
2 2 3 6 6 6 6 6 6 6 6 6 6 6 6 6 6 6 6 2
2 2 12 2 2 2 2 2 2 2 2 2 2 2 2 2 2 2 2 2

2 2 2 2 2 2 2 2 2 2 2 2 6 6 6 6 6 6 2 2
6 6 6 6 6 6 8 2 6 6 6 6 6 2 6 6 6 6 6 2
6 6 6 6 6 6 6 6 2 6 2 6 2 6 6 6 6 6 6 2
2 6 6 6 6 6 6 6 6 2 2 2 14 6 6 6 6 6 6 2
2 6 6 6 6 6 6 6 2 2 2 2 2 6 6 6 6 6 6 2
2 6 6 6 6 6 6 6 6 2 2 2 7 6 6 6 6 6 6 2
2 6 6 6 6 6 6 6 2 6 2 6 2 6 6 6 6 6 6 2
2 6 6 6 6 6 14 2 6 6 6 6 6 2 6 6 6 6 6 2
2 14 6 6 6 6 6 6 6 6 6 6 6 6 6 6 6 14 6 2
2 2 2 2 2 2 2 2 2 2 2 2 2 2 2 2 2 2 2 2

2 6 6 6 6 2 2 2 2 2 2 2 2 2 2 2 2 2 2 2
2 6 6 6 6 6 6 6 6 6 6 6 6 6 6 6 6 6 6 6
2 14 6 6 6 6 6 6 6 6 14 6 6 6 6 6 6 6 6 6
2 6 6 6 6 8 6 6 6 6 6 6 6 6 6 6 6 6 6 6
2 6 6 6 6 6 6 6 6 6 6 6 6 0 0 0 0 0 0 0
2 6 6 8 6 6 6 6 6 6 6 6 6 0 9 3 3 3 3 13
2 6 6 6 6 6 6 6 6 6 6 6 6 0 3 3 1 3 3 3
2 6 6 6 6 6 6 6 6 6 6 6 6 0 3 1 1 1 3 0
2 14 6 7 6 6 6 6 6 14 6 6 6 0 3 3 3 1 3 0
2 2 2 2 2 2 2 2 2 2 2 2 2 0 3 3 0 0 0 0

2 2 2 2 2 2 2 2 2 2 2 2 2 2 2 2 2 6 6 2
6 6 6 6 6 6 6 6 6 6 6 6 6 6 6 6 6 6 0 0
6 6 6 0 0 0 0 0 0 0 6 6 2 2 2 2 2 2 0 3
6 6 6 0 13 3 3 3 3 0 0 0 0 0 0 0 0 0 0 3
0 0 0 0 3 3 3 3 3 3 3 3 3 3 3 5 3 3 3 3
3 3 3 3 3 3 3 3 3 3 3 3 3 3 3 3 3 3 3 3
3 3 3 3 3 5 3 3 3 3 3 3 3 3 3 3 3 13 3 3
0 3 3 3 3 3 3 3 3 13 3 3 3 3 3 3 3 3 3 3
0 13 3 3 3 3 3 3 3 3 3 3 3 3 3 3 3 5 3 3
0 0 0 0 0 0 0 0 0 0 0 0 0 0 0 0 0 0 0 0

0 0 3 0 0 0 0 0 0 0 0 0 0 0 0 0 0 0 0 0
0 3 3 3 3 3 3 3 3 3 3 13 3 3 3 3 0 3 3 0
3 3 3 0 0 0 0 0 0 0 0 0 0 0 0 3 3 0 3 0
3 3 5 0 10 3 13 3 3 3 3 3 3 9 0 3 0 3 3 0
3 3 3 0 3 3 3 3 3 13 3 3 3 3 0 3 3 0 3 0
3 3 3 0 0 0 0 0 3 3 3 3 0 0 0 3 0 3 3 0
3 13 3 3 3 3 3 0 5 3 3 3 0 3 3 3 3 0 3 0
3 3 3 3 3 3 3 0 3 3 13 3 0 4 0 0 0 3 3 3
3 3 3 3 3 3 3 0 3 3 3 3 0 3 3 3 3 3 3 3
0 0 0 0 0 0 0 0 3 3 3 3 0 0 0 0 0 0 0 0

0 2 2 2 2 2 2 2 2 2 2 2 2 2 2 2 2 2 2 2
0 6 6 6 6 6 6 6 6 6 6 6 6 6 6 6 6 6 6 2
0 6 6 6 6 8 6 6 6 6 6 6 6 6 6 6 6 8 6 2
0 6 6 6 6 6 6 6 6 6 6 6 6 6 6 0 0 0 0 0
0 7 6 6 6 6 6 6 6 6 14 6 6 6 6 0 3 3 3 0
0 6 6 6 6 6 6 6 6 6 6 6 6 6 6 0 3 1 3 0
0 14 6 6 6 6 6 6 6 6 6 6 6 6 8 0 3 1 3 0
3 3 6 6 6 6 6 0 0 0 0 0 0 0 0 0 3 1 3 0
3 3 6 6 6 6 14 0 3 3 3 3 3 3 3 3 3 1 3 0
0 2 2 2 2 2 2 0 3 3 3 3 3 3 3 3 3 1 3 0

2 2 2 2 2 2 2 2 2 2 2 2 2 0 3 3 0 0 0 0
2 8 6 6 6 6 6 6 6 6 6 6 6 0 3 4 3 3 3 3
2 6 6 6 6 6 6 6 6 6 6 6 6 0 3 3 3 3 13 3
2 6 6 6 14 6 6 6 6 6 6 6 6 0 3 3 3 3 3 3
2 6 6 6 6 6 14 6 6 6 14 6 6 0 3 3 3 3 3 3
2 6 6 6 6 6 6 6 6 6 6 6 6 0 0 0 0 0 0 0
2 6 6 14 6 6 6 14 6 14 6 6 6 6 6 6 6 6 6 2
2 6 6 6 6 6 6 6 6 6 6 6 6 6 6 6 6 6 14 2
2 8 6 6 6 6 6 6 6 6 6 6 7 6 6 6 6 6 6 6
2 2 2 2 6 6 2 2 2 2 2 2 2 2 2 2 2 2 2 2

0 0 0 0 0 0 0 0 0 0 0 0 0 0 0 0 0 0 0 0
3 3 3 3 3 3 3 3 3 3 3 3 3 3 3 3 3 3 3 3
3 3 3 3 3 3 13 3 3 3 3 3 3 13 3 3 3 3 3 3
3 3 3 3 3 3 3 3 3 3 3 3 3 3 3 3 3 3 3 3
3 3 3 3 3 3 3 3 3 3 3 3 3 3 3 3 3 3 3 3
0 0 0 0 0 0 0 0 0 0 5 3 3 3 3 3 3 3 3 3
2 6 6 6 6 2 2 6 6 0 0 0 0 0 0 0 0 0 0 0
2 6 6 6 14 6 6 6 6 6 6 6 6 6 6 6 6 6 6 2
6 6 6 6 6 6 6 6 6 6 6 6 7 6 6 6 6 6 6 2
2 2 2 2 2 2 2 2 2 2 2 2 6 6 2 2 2 2 2 2

0 0 0 0 0 0 0 0 3 3 3 3 0 0 0 0 0 0 0 0
3 3 3 3 3 3 3 3 3 3 3 3 3 5 1 5 3 3 3 3
3 3 3 3 3 3 1 1 1 1 1 1 1 1 1 3 3 3 3 3
3 3 3 3 3 3 3 3 3 3 3 3 3 3 1 1 3 3 3 3
3 3 3 3 3 3 3 3 13 3 3 3 3 3 3 1 3 3 3 3
3 3 13 3 3 3 3 3 3 3 3 3 3 3 3 12 3 3 3 3
0 0 0 0 0 0 0 0 0 0 0 0 0 0 0 0 0 0 0 0
2 6 6 6 6 6 6 6 6 6 6 6 6 6 6 6 6 6 6 6
2 6 6 6 6 6 6 6 6 6 6 6 6 6 6 6 6 6 6 2
2 2 2 2 2 2 6 6 2 2 2 2 2 2 2 2 2 2 2 2

0 2 2 2 2 2 2 0 3 3 3 3 3 3 3 3 3 1 3 0
3 3 3 3 3 3 3 3 3 3 13 3 3 3 3 3 3 1 3 0
3 4 1 1 1 1 1 1 1 1 1 1 1 1 1 1 1 1 3 0
3 3 1 3 3 3 3 3 3 3 3 3 3 13 3 3 3 3 3 0
3 3 1 3 1 1 1 1 1 1 1 1 1 1 1 1 1 1 1 0
3 3 17 3 3 3 3 3 3 3 3 3 3 3 3 3 3 3 3 0
0 0 0 0 0 0 0 0 0 0 0 0 0 0 0 0 3 0 0 0
6 6 6 6 14 6 6 6 6 6 6 6 6 6 6 6 6 6 6 2
2 8 6 6 6 6 6 6 6 6 6 6 14 6 6 6 6 6 6 2
2 2 2 2 2 2 2 2 2 2 2 2 2 2 2 2 2 2 2 2

2 2 2 2 6 6 2 2 2 2 2 2 2 2 2 2 2 2 2 2
2 6 6 6 6 6 6 6 6 6 6 6 6 6 6 6 6 6 6 6
2 6 6 6 6 6 6 6 6 6 6 6 6 8 6 6 6 6 6 2
2 6 6 6 6 6 6 6 6 6 6 6 6 8 6 6 6 6 6 2
2 6 6 6 6 6 6 6 6 6 6 6 6 6 6 6 6 6 6 2
2 6 14 6 6 6 6 6 6 6 6 6 6 6 6 6 6 6 6 2
2 6 6 6 6 6 6 6 6 6 6 6 6 6 6 6 6 6 6 2
2 6 6 6 6 6 6 6 6 6 6 6 6 6 6 6 6 6 6 2
2 6 6 6 6 6 6 6 6 6 14 6 6 6 6 6 6 6 6 2
2 7 6 6 6 6 6 6 6 6 6 6 6 6 6 6 6 6 6 2

2 2 2 2 2 2 2 2 2 2 2 2 6 6 2 2 2 2 2 2 
6 6 6 6 6 2 6 6 6 6 6 6 6 6 6 6 6 6 6 6
2 6 6 6 6 6 2 6 6 6 6 8 6 6 6 6 8 6 6 6
2 14 6 6 14 6 6 2 6 6 6 6 6 6 6 6 6 6 6 6
2 6 6 6 6 6 6 6 2 6 6 6 6 6 6 6 6 6 6 6
2 6 6 6 6 6 6 6 6 2 6 7 6 6 6 6 7 6 6 6
2 6 6 6 14 6 6 14 6 11 2 2 2 2 2 2 2 2 2 2
2 6 6 6 6 6 6 6 6 2 6 6 6 6 6 6 6 6 6 6 
2 6 6 6 14 6 6 14 2 6 6 6 6 6 6 6 6 6 6 6
2 2 2 2 2 2 2 2 2 2 6 2 2 2 2 2 2 2 2 2

2 2 2 2 2 2 6 6 2 2 2 2 2 2 2 2 2 2 2 2
6 6 6 6 6 6 6 2 6 6 6 6 6 6 6 6 6 6 6 6
6 6 6 6 6 6 2 6 6 6 6 6 6 6 6 6 6 6 6 6
6 6 6 6 6 2 6 6 6 6 6 2 2 2 2 2 2 2 2 2
6 6 6 6 2 6 6 2 2 2 2 2 0 0 0 0 0 0 0 0
6 6 6 2 6 6 6 2 0 0 0 0 0 3 3 3 3 3 3 3
2 2 2 6 6 6 6 2 0 3 3 3 3 3 3 13 3 3 3 3
6 6 6 6 6 6 6 2 0 3 3 13 3 3 3 3 3 3 3 3
6 6 6 6 6 6 6 2 0 3 3 3 3 3 3 3 3 3 3 3
2 2 2 2 2 2 2 2 0 3 3 3 3 3 5 1 1 1 1 1

2 2 2 2 2 2 2 2 2 2 2 2 2 2 2 2 2 2 2 2
6 6 6 6 6 6 6 6 6 6 6 6 6 6 6 6 6 6 7 2
6 6 6 6 6 6 6 6 6 6 2 2 2 14 2 2 2 2 6 2
2 2 2 2 2 2 2 2 8 2 2 0 0 0 0 0 0 2 3 2
0 0 0 0 0 0 0 0 0 0 0 0 3 3 3 9 0 2 3 2
3 3 3 3 3 3 3 3 13 3 3 3 3 3 3 3 0 2 3 2
3 3 13 3 3 3 3 3 3 3 3 3 3 3 3 3 0 2 3 2
3 3 3 1 1 1 1 1 1 1 1 1 1 3 3 3 0 2 3 2
3 3 3 1 3 3 5 3 3 3 3 5 1 3 3 3 0 2 13 2
1 1 1 1 3 3 3 3 3 3 3 3 1 3 3 3 0 2 3 2

2 6 6 6 6 6 6 14 6 6 6 6 6 6 6 6 6 6 6 2
2 6 6 6 6 6 6 6 6 6 6 6 6 14 6 6 6 6 6 6
2 2 2 2 2 2 2 2 2 2 2 2 2 2 2 2 2 2 2 2
2 15 3 3 3 6 6 14 6 14 6 6 6 6 6 6 6 6 6 6
2 3 3 3 3 6 6 14 6 6 14 6 6 6 14 6 6 6 6 6
2 3 3 3 3 6 14 6 6 6 6 14 6 6 6 14 6 6 6 6
2 3 3 3 3 6 6 6 6 14 6 6 6 6 14 6 6 14 6 6
2 14 6 6 6 6 6 14 6 6 6 14 6 6 6 6 6 6 6 6
2 8 6 6 6 14 6 6 6 6 6 6 14 6 6 6 6 14 6 6
2 2 2 2 2 2 2 2 2 2 2 2 2 2 2 2 2 2 2 2

2 2 2 2 2 2 2 2 2 2 12 2 2 2 2 2 2 2 2 2
6 6 6 6 6 3 3 3 3 3 3 2 9 6 6 6 6 6 6 6
2 2 2 2 2 2 2 2 2 2 2 2 6 6 6 6 6 6 6 6
6 6 6 6 6 6 6 6 6 6 6 14 6 6 6 14 6 6 6 6
6 6 6 14 6 6 6 6 6 6 6 6 6 6 6 6 6 6 6 6
6 6 6 6 6 6 6 6 6 6 6 6 6 6 6 6 6 6 6 6
6 6 6 6 6 6 6 6 6 6 6 6 6 6 6 6 6 6 6 6
6 6 6 6 6 6 6 14 6 6 6 6 6 6 6 8 6 6 6 6
6 6 6 6 6 6 6 6 6 6 6 6 6 6 6 6 6 6 6 6
2 2 2 2 2 2 2 2 2 2 2 2 2 2 2 2 2 2 2 2

2 2 2 2 2 2 2 2 0 3 3 3 3 3 3 1 1 1 1 1
6 6 6 6 6 6 6 2 0 3 3 3 3 3 3 3 3 13 3 3
6 6 6 6 6 6 6 2 0 3 3 3 3 3 3 3 3 3 3 3
6 14 6 6 6 6 6 2 0 3 3 3 13 3 3 3 3 3 3 3
6 6 6 6 6 6 6 2 0 3 3 3 3 3 3 3 3 3 3 3
6 6 6 6 6 6 6 2 0 5 3 3 3 3 3 3 3 3 3 3
6 6 6 6 6 14 6 2 0 0 0 0 0 0 0 0 0 0 0 0
6 6 6 6 6 6 6 2 2 2 2 2 2 2 2 2 2 2 2 2
6 6 14 6 6 6 6 6 3 3 3 12 3 3 13 3 3 3 3 3
2 2 2 2 2 2 2 2 2 2 2 2 2 2 2 2 2 2 2 2

1 1 1 1 3 3 3 3 3 3 3 3 1 3 3 3 0 2 3 2
3 3 3 3 3 3 3 3 3 3 3 3 17 3 3 3 0 2 3 2
3 3 13 3 3 3 3 3 3 5 3 3 1 3 13 3 0 2 3 2
3 3 3 3 3 3 3 3 3 3 3 3 1 3 3 3 0 2 3 2
3 3 3 4 3 13 3 3 3 3 3 3 1 3 3 3 0 2 3 2
3 3 3 3 3 3 3 3 3 3 3 5 1 3 3 10 0 2 3 2
0 0 0 0 0 0 0 0 3 0 0 0 0 0 0 0 0 2 3 2
2 2 2 2 2 2 2 2 3 2 2 2 2 2 2 2 2 2 13 2
3 3 3 3 3 3 3 3 3 3 3 3 3 3 13 3 3 3 3 2
2 2 2 2 2 2 2 2 2 2 2 2 2 2 2 2 2 2 2 2
