0 0 0 1
0 0 0 1
1 0 1 1
1 1 1 1
1 1 0 0
1 1 0 0

0 0 0 0 0 0 0 0 0 0 0 0 0 0 0 0 0 0 0 0
0 5 3 3 3 3 16 3 3 3 3 3 3 3 3 3 3 1 1 0
0 3 3 3 3 3 3 3 3 3 3 3 3 3 3 1 5 3 1 0
0 3 3 3	3 3 3 3 3 3 3 3 3 3 3 1 1 3 13 0
0 3 3 13 3 3 3 3 1 1 1 3 1 3 3 1 1 1 1 0
0 3 3 3 3 3 3 3 1 3 3 3	1 3 3 3 3 3 3 0
0 3 3 13 3 3 3 3 1 1 1 1 1 3 3 3 3 3 3 0
0 3 3 3 3 3 3 3 3 3 3 3 3 3 3 3 3 3 3 3
0 4 3 3 3 3 3 3 3 3 3 3 3 3 3 3 3 3 3 0
0 0 12 0 0 0 0 0 0 0 0 0 0 0 0 0 0 0 0 0

0 0 0 0 0 0 0 0 0 0 0 0 0 0 0 0 0 0 0 0
0 1 13 1 3 3 3 3 3 3 3 3 3 3 3 3 1 13 1 0
0 3 5 3 3 3 3 3 3 3 3 3 3 3 3 3 3 5 3 0
0 1 13 1 3 3 3 3 3 3 3 3 3 3 3 3 1 13 1 0
0 3 3 3 3 3 3 3 3 3 3 3 3 3 3 3 3 3 3 0
0 3 1 3 1 3 1 3 1 3 1 3 1 3 1 3 1 3 1 0
0 3 3 3 3 3 3 3 3 3 3 3 3 3 3 3 3 3 3 0
3 3 13 3 13 3 13 3 13 3 13 3 13 3 13 3 13 3 13 3
0 3 3 3 3 3 3 3 3 3 3 3 3 3 3 3 3 3 9 0
0 0 0 0 0 0 0 0 0 0 0 0 0 0 0 0 0 0 0 0

0 0 0 0 0 0 0 0 0 0 0 0 0 0 0 0 0 0 0 0
0 1 1 13 1 3 1 5 3 1 5 1 1 3 1 1 1 3 3 1
0 1 9 13 1 3 1 3 3 1 3 1 13 3 1 3 1 1 3 1
0 1 1 13 1 3 1 3 3 1 3 1 13 3 1 3 1 1 1 1
0 3 1 13 1 3 1 3 3 1 3 1 13 3 1 3 1 3 1 1
0 1 1 13 1 3 1 1 3 1 3 1 1 3 1 1 1 3 3 1
0 3 3 3 3 3 3 3 3 3 3 3 3 3 3 3 3 3 3 0
3 3 3 3 3 3 3 3 3 3 3 3 3 3 3 3 3 3 3 0
0 3 3 3 3 3 3 3 3 3 3 3 3 3 3 3 3 3 3 0
0 0 0 0 0 0 0 0 3 3 3 0 0 0 0 0 0 0 0 0

2 2 2 2 2 2 2 2 2 2 2 2 2 2 2 2 2 2 2 2
2 1 1 1 1 1 1 1 1 1 1 1 1 1 1 1 1 14 1 2
2 1 6 1 6 1 8 1 6 1 6 1 6 1 1 14 1 6 1 2
2 1 6 1 6 1 6 1 6 1 6 1 14 1 1 6 1 6 1 2
2 1 6 1 6 1 6 1 6 1 14 1 6 1 1 6 1 6 1 2
2 6 6 6 6 6 6 6 14 6 6 6 6 6 6 6 6 6 2 2
2 6 6 6 6 6 14 6 6 6 6 6 6 6 6 6 6 6 2 2
2 6 6 6 6 6 6 6 6 6 6 6 6 6 6 6 6 14 2 2
2 14 6 6 6 6 6 6 6 6 6 6 6 6 6 6 6 6 2 2
2 2 2 2 2 2 2 2 2 2 2 6 2 2 2 2 2 2 2 2

0 0 3 0 0 0 0 0 0 0 0 0 0 0 0 0 0 0 0 0
0 1 3 1 3 3 3 3 3 3 3 3 3 3 3 3 3 3 3 0
0 3 3 3 3 3 3 3 3 3 3 3 3 3 3 3 3 3 3 0
0 13 3 3 3 3 3 3 3 3 3 13 3 3 3 3 3 3 3 0
0 3 3 3 3 3 3 3 3 3 3 3 3 3 3 3 3 3 3 0
0 13 3 3 3 3 3 3 3 3 3 13 3 3 3 3 3 3 3 0
0 3 3 3 3 3 3 3 3 3 3 3 3 3 3 3 3 3 3 0
0 3 3 3 3 3 3 3 3 3 3 3 3 3 3 3 3 3 3 0
0 3 3 3 3 3 3 3 3 3 3 3 3 3 3 3 3 3 5 0
0 0 0 0 3 3 0 0 0 0 0 0 0 0 0 0 0 0 0 0

0 0 0 0 0 0 0 0 0 0 0 0 0 0 0 0 0 0 0 0
0 13 3 13 1 3 3 3 3 3 3 3 3 3 3 3 3 3 3 0
0 3 3 3 5 1 3 3 3 3 3 3 3 3 3 3 3 3 3 0
0 3 1 1 1 1 3 3 3 3 3 3 3 3 3 3 3 3 3 0
0 3 3 3 3 3 3 3 3 3 3 3 3 3 3 3 3 3 3 3
0 3 3 3 3 3 3 3 3 3 3 3 3 3 3 3 3 3 3 3
0 3 1 1 1 1 3 3 3 3 3 3 3 3 3 3 3 3 3 0
0 3 3 3 4 1 3 3 3 3 3 3 3 3 3 3 3 3 3 0
0 13 3 13 1 3 3 3 3 3 3 3 3 3 3 3 3 3 3 0
0 0 0 0 0 0 0 0 0 0 0 0 0 0 0 0 0 0 0 0

0 0 0 0 0 0 0 0 3 3 3 0 0 0 0 0 0 0 0 0
0 3 3 3 3 3 3 3 3 3 3 3 3 3 3 3 3 3 3 0
0 3 3 3 3 3 3 3 3 3 3 3 3 3 3 3 3 3 3 0
0 3 3 3 3 3 3 3 3 3 3 3 3 3 3 3 3 3 3 3
3 3 3 3 3 3 3 3 3 3 3 3 3 3 1 1 1 3 1 0
3 1 3 1 3 3 1 3 3 1 3 1 3 3 1 3 1 4 1 0 
0 1 5 1 3 1 3 1 3 1 3 1 3 3 1 1 3 1 3 0
0 1 13 1 3 1 1 1 3 1 13 1 13 3 1 3 3 1 3 0
0 3 1 1 3 1 3 1 5 1 1 1 1 3 1 1 3 1 3 0
0 0 0 0 0 0 0 0 0 0 0 0 0 0 0 0 0 0 0 0

0 2 2 2 2 2 2 2 2 2 2 3 2 2 2 2 2 2 2 2
0 14 6 6 6 6 6 6 6 6 6 3 6 6 6 6 6 6 6 2
0 6 6 6 6 6 6 6 6 6 6 3 6 6 6 6 6 6 6 2
3 3 3 6 6 6 6 6 6 6 6 3 6 6 6 6 6 6 6 2
0 3 3 3 3 3 3 3 13 3 3 3 6 14 6 6 6 6 6 2
0 3 3 3 3 3 3 3 13 3 3 3 6 14 6 6 6 6 6 2
0 6 6 6 6 6 6 6 6 6 6 3 6 6 6 6 6 6 6 2
0 6 6 6 6 6 6 6 6 6 6 3 6 6 6 6 6 6 6 2
0 14 6 6 6 6 6 6 6 6 6 3 6 6 6 6 6 6 8 2
0 2 2 2 2 2 2 2 2 2 2 3 2 2 2 2 2 2 2 2

2 2 2 2 3 3 2 2 2 2 2 2 2 2 2 2 2 2 2 2
2 7 6 6 3 3 6 6 6 6 6 6 6 6 6 6 6 6 8 2
2 6 6 6 6 6 6 6 6 6 6 6 6 6 6 6 6 6 6 2
2 6 6 6 6 6 6 6 6 6 6 6 6 6 6 6 6 6 6 2
2 6 6 6 6 6 6 6 6 6 6 6 6 6 6 6 6 6 6 2
2 6 6 6 6 6 6 6 6 6 6 6 1 6 6 6 6 6 6 2
2 14 6 6 6 6 6 6 6 6 6 14 1 6 6 6 6 6 6 2
2 14 6 6 6 6 6 6 6 6 6 14 1 14 6 6 6 6 14 2
2 14 6 6 6 6 6 6 6 6 6 14 1 6 6 6 6 6 6 2
2 14 6 6 6 6 6 6 6 6 6 14 1 14 6 6 6 6 14 2

0 0 0 0 0 0 0 0 0 0 0 0 0 0 0 0 0 0 0 0
0 13 13 13 13 13 13 13 13 13 13 3 3 3 3 3 3 3 3 0
0 13 3 13 3 13 3 13 3 13 3 3 3 3 3 3 3 1 3 0
0 3 3 3 3 3 3 3 3 3 3 3 3 3 3 3 3 1 3 0
0 3 3 3 3 3 3 3 3 3 3 3 3 3 3 3 3 1 15 0
0 3 3 3 3 3 3 3 3 3 3 3 3 3 3 3 3 1 1 0
0 3 3 3 3 3 3 3 3 3 3 3 3 3 3 3 3 3 3 0
0 3 3 3 3 3 3 3 3 3 3 3 3 3 3 3 3 3 3 0
0 5 5 3 3 3 3 3 3 3 3 3 3 3 3 3 3 4 5 0
0 0 0 0 0 0 3 0 0 0 0 0 0 0 0 0 0 0 0 0

2 2 2 2 2 2 2 2 2 2 2 2 2 2 2 2 2 2 2 2
2 11 9 6 2 14 6 6 6 8 6 6 6 6 6 6 6 6 6 2
2 2 2 6 2 6 2 6 6 6 6 6 6 6 6 6 6 6 6 2
2 14 6 14 2 6 2 6 6 6 6 6 6 6 6 6 6 6 6 2
2 6 2 2 2 6 2 6 6 6 6 6 6 6 6 6 6 6 6 2
2 14 6 6 6 14 2 6 6 6 6 6 6 6 6 6 6 6 6 2
2 2 2 2 2 2 2 6 6 6 6 6 6 6 6 6 6 6 6 2
2 6 6 6 6 6 6 6 6 6 6 6 6 6 6 6 6 6 6 2
2 8 6 6 6 6 6 6 6 6 6 6 6 6 6 6 6 6 6 2
2 2 2 2 2 2 2 2 2 2 2 2 2 2 2 2 2 2 6 2

2 2 2 2 2 2 2 2 2 2 2 6 2 2 2 2 2 2 2 2
2 2 2 2 2 2 2 2 2 14 2 6 2 2 2 2 2 2 2 2
2 6 6 6 6 6 6 6 6 6 2 6 2 2 2 2 2 2 2 2
2 6 6 2 2 2 2 2 2 2 2 6 2 2 2 2 2 2 2 2
2 6 6 6 6 6 6 6 6 6 6 6 2 2 2 2 2 2 2 2
2 6 6 2 2 2 2 2 2 2 2 6 2 2 2 2 2 2 2 2
2 6 6 6 6 6 6 6 6 6 2 6 2 2 2 2 2 2 2 2
2 2 2 2 2 2 2 2 2 6 2 6 2 2 2 2 2 2 2 2
2 14 6 6 8 6 6 6 6 6 2 6 2 2 2 2 2 2 2 2
2 2 2 2 2 2 2 2 2 2 2 6 2 2 2 2 2 2 2 2

2 14 6 6 6 6 6 6 6 6 6 6 1 6 6 6 6 6 6 2
2 6 6 6 6 6 6 6 6 6 14 6 1 6 6 6 6 6 6 2
2 6 6 2 6 14 6 6 2 2 2 6 1 6 6 6 6 6 6 2
2 6 6 6 2 6 6 6 2 2 2 6 1 6 6 6 14 6 6 2
2 6 2 2 6 6 6 6 2 2 2 6 1 6 6 14 6 6 6 2
2 6 6 2 6 6 6 6 6 6 14 6 1 6 6 6 6 6 6 6
2 9 6 6 2 6 6 6 6 8 6 6 1 6 6 14 6 6 6 2
2 2 2 2 2 2 2 2 2 2 2 2 1 2 2 2 2 2 2 2
2 8 6 6 6 6 6 6 14 6 6 6 6 6 6 6 6 6 6 2
2 6 14 6 6 6 6 6 6 6 6 6 1 2 2 2 2 6 6 2

0 0 0 0 0 0 12 0 0 0 0 0 0 0 0 0 0 0 0 0
2 7 6 6 6 6 3 6 6 6 6 6 14 6 6 6 6 6 8 2
2 6 6 6 6 6 6 6 6 6 6 6 6 6 6 14 6 6 6 2
2 6 6 6 6 6 6 6 14 6 6 6 6 6 6 6 6 6 6 2
2 2 2 2 2 2 2 2 2 2 2 6 6 6 14 6 6 6 6 2
6 6 6 6 6 6 6 6 14 6 2 6 6 6 6 6 6 6 6 2
2 6 6 6 6 6 6 6 6 6 2 14 6 6 6 6 6 6 6 2
2 6 6 6 6 6 6 6 6 6 2 6 6 6 6 14 6 6 6 2
2 6 6 6 6 6 6 6 6 6 2 14 6 6 6 6 6 6 6 2
2 2 2 2 2 6 6 2 2 2 2 6 6 2 2 2 2 2 2 2

2 2 2 2 2 2 2 2 2 2 2 2 2 2 2 2 2 2 6 2
2 14 6 6 6 6 6 6 6 6 6 6 6 6 6 6 6 6 14 2
2 6 6 6 6 6 6 1 1 1 1 1 1 1 6 6 6 6 6 2
2 6 6 6 6 6 6 6 7 2 1 2 6 6 6 6 6 6 6 2
2 6 6 6 6 6 6 1 1 1 1 1 1 1 6 6 6 6 6 2
2 6 6 6 6 6 6 1 1 1 1 1 1 1 6 6 6 6 6 2
2 6 6 6 6 6 6 6 8 2 1 2 6 6 6 6 6 6 6 6
2 6 6 6 6 6 6 1 1 1 1 1 1 1 6 6 6 6 6 2
2 14 6 6 6 6 6 6 6 6 6 6 6 6 6 6 6 6 14 2
2 2 2 2 2 2 2 2 2 2 2 2 2 2 2 2 2 2 2 2

2 2 2 2 2 2 2 2 2 2 2 6 2 2 2 2 2 2 2 2
2 14 6 6 6 6 6 6 6 6 6 6 6 6 6 6 6 6 6 2
2 6 6 6 6 6 6 6 6 6 6 6 6 6 6 6 6 14 6 2
2 2 2 2 2 2 2 2 2 6 6 6 6 6 6 6 6 6 6 2
2 6 6 6 6 6 6 6 6 6 6 2 2 2 2 2 2 2 2 2
2 2 2 2 2 2 2 2 2 6 6 6 6 6 6 6 6 6 8 2
6 6 6 6 6 6 6 6 6 6 6 2 2 2 2 2 2 2 2 2
2 6 6 6 6 6 6 6 6 6 6 6 6 6 6 6 14 6 6 2
2 6 6 6 14 6 6 6 6 6 6 6 6 6 6 6 6 6 6 2
2 2 2 2 2 2 2 2 2 2 2 2 2 2 2 2 2 2 2 2

2 14 6 6 6 6 6 6 6 6 6 6 1 2 2 2 2 6 6 2
2 6 14 6 6 6 6 6 6 6 2 6 1 6 6 6 6 6 2 2
2 6 6 14 6 6 6 6 6 6 2 6 1 6 6 6 6 2 2 2
2 6 6 6 14 6 6 6 6 6 2 6 1 6 2 2 2 2 6 6
2 6 6 6 6 14 6 6 6 6 2 6 1 6 2 6 6 6 6 2
2 6 6 6 6 6 14 6 6 6 2 6 1 6 2 2 6 6 6 2
2 6 6 6 6 6 6 14 6 6 2 6 1 6 6 2 2 6 6 2
2 6 6 6 6 6 6 6 14 6 2 8 1 6 6 6 2 2 6 6
2 6 6 6 6 6 6 6 6 14 2 2 1 6 6 6 6 2 2 2
2 6 6 6 6 6 6 6 6 6 6 6 1 6 6 14 6 6 2 2

2 2 2 2 2 6 6 2 2 2 2 6 6 2 2 2 2 2 2 0
2 6 6 6 6 6 6 6 6 6 2 2 6 6 6 6 6 6 3 0
2 6 6 6 6 6 6 6 6 6 6 2 6 6 6 6 14 6 3 3
6 6 6 14 6 6 6 6 6 6 6 2 7 6 6 6 6 6 3 0
2 2 2 2 2 2 2 2 2 2 2 2 2 2 2 2 2 2 2 0
2 6 6 6 6 6 6 6 9 2 8 6 6 6 6 6 6 6 3 3
2 6 6 6 6 6 6 6 6 2 6 6 6 6 6 6 14 6 3 3
6 6 6 6 6 6 6 6 6 2 6 6 6 6 6 6 6 6 6 0
2 6 14 6 6 6 6 6 6 2 6 6 6 6 6 6 6 6 6 0
2 2 6 2 2 2 2 2 2 2 2 6 2 2 2 2 2 2 2 0

0 0 0 0 0 0 0 0 0 0 0 0 0 0 0 0 0 0 0 0
0 3 3 3 3 3 13 3 3 3 3 3 3 3 3 3 3 3 3 3
3 3 3 3 3 3 13 3 3 3 3 3 3 3 3 3 3 3 3 3
0 3 3 3 3 3 13 3 3 3 3 5 3 3 3 3 3 3 3 3
0 1 1 1 1 1 1 1 1 1 1 1 1 1 1 17 1 1 1 0
3 3 3 3 3 3 3 3 3 3 13 1 3 3 3 3 3 3 3 0
3 3 3 3 3 3 3 3 3 3 13 1 3 3 3 3 3 3 3 3
0 3 3 3 3 3 3 3 3 3 3 1 3 3 3 3 3 3 13 3
0 5 3 3 3 3 3 3 3 3 3 1 3 3 3 3 3 3 13 0
0 0 0 3 3 3 0 0 0 0 0 0 0 0 3 3 0 0 0 0

0 0 0 0 0 0 0 0 0 0 0 0 0 0 0 0 0 0 0 0
3 3 3 3 3 5 3 3 13 3 3 3 3 3 3 3 3 3 3 0
3 3 3 3 3 3 3 3 13 3 3 3 3 3 3 1 3 3 3 0
3 3 3 3 3 3 3 3 13 3 3 3 3 3 3 1 3 3 3 0
0 1 1 1 1 1 1 1 1 1 1 1 1 1 13 1 3 3 3 0
0 3 3 13 3 3 3 3 3 3 3 3 4 1 3 1 3 3 3 0
3 3 3 3 3 3 3 3 3 13 3 3 3 1 3 1 9 3 3 0
3 3 3 3 3 3 3 13 3 3 3 3 3 1 3 1 1 1 3 0
0 3 3 3 3 13 3 3 3 3 3 3 3 1 1 3 3 3 3 0
0 0 0 0 0 0 0 0 0 0 0 0 3 0 0 0 3 0 0 0

2 6 6 6 6 6 6 6 6 6 6 6 1 6 14 6 6 6 2 2
2 6 14 6 6 2 2 6 2 6 6 6 1 6 6 6 6 6 6 2
2 14 6 6 6 2 6 6 2 6 6 6 1 6 6 6 2 2 6 2
2 6 6 6 6 2 7 6 2 6 6 6 1 14 6 6 2 6 6 6
2 6 6 14 6 2 2 2 2 6 6 6 1 1 1 1 1 1 1 1
2 6 6 6 6 14 6 6 6 2 6 6 6 6 6 6 6 6 6 6
2 6 6 6 6 6 6 6 6 2 6 2 6 6 6 14 6 6 6 6
2 6 6 6 6 6 14 6 6 2 6 2 6 6 6 6 6 6 6 6
2 14 6 6 6 6 6 6 6 2 8 2 6 6 6 6 6 6 6 6
2 2 2 2 2 2 2 2 2 2 2 2 2 2 2 2 2 2 2 2

2 2 6 2 2 2 2 2 2 2 2 6 2 2 2 2 2 2 2 0
2 6 6 6 6 6 6 6 6 14 2 6 6 6 6 6 6 6 6 0
2 6 6 6 6 6 6 6 6 14 2 6 6 6 6 6 6 6 6 0
6 6 6 6 6 6 11 6 6 7 2 6 6 6 6 6 6 6 6 0
1 1 1 1 1 1 1 1 1 1 1 1 1 1 1 1 1 1 14 0
6 6 6 6 6 6 6 6 6 6 6 6 6 6 6 6 6 6 14 0
6 6 6 6 6 6 6 6 6 6 6 6 6 6 6 6 6 6 14 0
6 6 6 6 6 6 6 6 6 6 6 6 6 6 6 6 6 6 14 0
6 6 6 6 6 6 6 6 8 6 6 6 6 6 6 6 6 6 14 0
2 2 2 2 2 2 2 2 2 2 2 2 2 2 2 2 2 2 2 0

0 0 0 3 3 3 0 0 0 0 0 0 0 0 3 3 0 0 0 0
0 3 3 3 3 3 3 3 3 5 1 3 3 3 3 3 3 3 13 0
0 3 3 3 3 3 3 3 3 3 1 3 3 3 3 3 3 13 3 0
0 13 3 3 3 3 3 3 3 3 1 3 3 3 3 3 3 3 3 0
0 3 13 3 3 3 3 3 3 3 1 3 3 3 3 3 3 3 3 0
0 3 3 13 3 3 3 3 3 3 1 1 1 3 3 3 3 3 3 0
0 1 1 3 13 3 3 3 3 3 3 3 3 3 3 3 3 3 3 0
0 3 3 3 1 13 3 3 3 3 1 1 1 3 3 3 3 3 3 0
0 4 3 3 1 3 13 3 3 3 1 3 3 3 3 3 3 3 3 0
0 0 0 0 0 0 0 0 0 0 0 0 0 0 0 0 0 0 0 0

0 0 0 0 0 0 0 0 0 0 0 0 3 0 0 0 3 0 0 0
0 13 3 3 3 3 3 1 3 3 3 3 3 1 3 3 3 3 3 0
0 3 13 3 3 3 3 1 3 3 3 3 3 1 3 3 3 3 3 0
0 3 3 13 3 3 1 3 3 3 3 3 3 1 1 3 3 3 3 0
0 3 3 3 13 3 1 5 3 1 1 3 3 1 3 3 3 3 3 0
0 3 3 3 3 13 1 1 1 3 3 3 3 1 3 3 3 3 3 0
0 3 3 3 3 3 13 3 3 3 3 3 3 3 3 3 3 3 3 0
0 3 3 3 3 3 3 13 3 3 3 3 3 1 1 3 3 3 3 0
0 5 3 3 3 3 3 3 13 3 3 3 3 1 3 3 3 3 3 0
0 0 0 0 0 0 0 0 0 0 0 0 0 0 0 0 0 0 0 0